Xu, Xu, Xu, Xu, Xu, Xu, Xu, Xu, Xu, Xu, Xu, Xu, Xu, Xu, Xu, Xu, Xu, Xu, Xu, Xu, Xu, Xu, Xu, Xu, Xu, Xu, Xu, Xu, Xu, Xu, Xu, Xu, Xu, Xu, Xu, Xu, Xu, Xu, Xu, Xu, Xu, Xu, Xu, Xu, Xu, Xu
Xu, Xu, Xu, Xu, Xu, Xu, Xu, Xu, Xu, Xu, Wo, Wo, Wo, Xu, Xu, Xu, Xu, Xu, Xu, Xu, Xu, Xu, Xu, Xu, Xu, Xu, Xu, Xu, Xu, Xu, Xu, Xu, Xu, Xu, Xu, Xu, Xu, Xu, Xu, Xu, Xu, Xu, Xu, Xu, Xu, Xu
Xu, Xu, Xu, Xu, Xu, Xu, Xu, Xu, Xu, Wo, Wo, Wo, Wo, Wo, Wo, Xu, Xu, Xu, Xu, Xu, Xu, Xu, Xu, Xu, Xu, Xu, Xu, Xu, Xu, Xu, Xu, Xu, Xu, Xu, Xu, Xu, Xu, Xu, Xu, Xu, Xu, Xu, Xu, Xu, Xu, Xu
Xu, Xu, Xu, Xu, Xu, Xu, Xu, Xu, Xu, Wo, Wo, Wo, Wo, Wo, Wo, Xu, Xu, Xu, Xu, Xu, Xu, Xu, Xu, Xu, Xu, Xu, Xu, Xu, Xu, Xu, Xu, Xu, Xu, Xu, Xu, Xu, Xu, Xu, Xu, Xu, Xu, Xu, Xu, Xu, Xu, Xu
Xu, Xu, Xu, Xu, Xu, Xu, Xu, Xu, Xu, Xu, Xu, Wo, Wo, Wo, Wo, Xu, Xu, Xu, Xu, Xu, Xu, Xu, Xu, Xu, Xu, Xu, Xu, Xu, Xu, Xu, Xu, Xu, Xu, Xu, Xu, Xu, Xu, Xu, Xu, Xu, Xu, Xu, Xu, Xu, Xu, Xu
Xu, Xu, Xu, Xu, Xu, Xu, Xu, Xu, Xu, Xu, Xu, Wo, Wo, Wo, Wo, Xu, Xu, Xu, Xu, Xu, Xu, Xu, Xu, Xu, Xu, Xu, Xu, Xu, Xu, Xu, Xu, Xu, Xu, Xu, Xu, Xu, Xu, Xu, Xu, Xu, Xu, Xu, Xu, Xu, Xu, Xu
Xu, Xu, Xu, Xu, Xu, Xu, Xu, Xu, Xu, Xu, Ww, Wo, Wo, Wo, Wo, Xu, Xu, Xu, Xu, Xu, Xu, Xu, Xu, Xu, Xu, Xu, Xu, Xu, Xu, Xu, Xu, Xu, Xu, Xu, Ur^Vu, Xu, Xu, Xu, Xu, Xu, Xu, Xu, Xu, Xu, Xu, Xu
Xu, Xu, Xu, Xu, Xu, Xu, Xu, Xu, Xu, Xu, Ww, Wo, Wo, Wo, Wo, Wo, Ww, Xu, Xu, Xu, Xu, Xu, Xu, Xu, Xu, Xu, Xu, Xu, Xu, Xu, Xu, Xu, Ur^Vu, Ur, Ur, Ur, Ur^Vu, Xu, Xu, Xu, Xu, Xu, Xu, Xu, Xu, Xu
Xu, Xu, Xu, Xu, Xu, Xu, Xu, Xu, Xu, Xu, Xu, Ww, Ww, Wo, Ww, Ww, Ww, Ww, Xu, Xu, Xu, Xu, Xu, Xu, Xu, Xu, Xu, Xu, Xu, Xu, Xu, Xu, Ur, Ur, Ur, Ur, Xu, Xu, Xu, Xu, Xu, Xu, Xu, Xu, Xu, Xu
Xu, Xu, Xu, Xu, Xu, Xu, Xu, Xu, Xu, Xu, Xu, Xu, Xu, Ww, Ww, Ww, Ww, Ww, Xu, Xu, Xu, Xu, Xu, Xu, Xu, Xu, Xu, Xu, Xu, Xu, Xu, Xu, Uu, Ur, Ur, Ur, Xu, Xu, Xu, Xu, Xu, Xu, Xu, Xu, Xu, Xu
Xu, Xu, Xu, Xu, Xu, Xu, Xu, Xu, Xu, Xu, Xu, Xu, Xu, Xu, Ww, Ww, Ww, Xu, Xu, Xu, Xu, Xu, Uu, Xu, Uu, Xu, Xu, Xu, Xu, Xu, Uh, Uh, Uh, Uh, Ur, Uh, Uh, Xu, Xu, Xu, Xu, Xu, Xu, Xu, Xu, Xu
Xu, Xu, Xu, Xu, Xu, Xu, Xu, Xu, Xu, Xu, Xu, Xu, Uu, Ds, Ds, Ww, Ww, Xu, Wwf, Ds, Ds, Uu, Uu, Uu, Uu, Xu, Xu, Xu, Xu, Uh, Uh, Uh, Uh, Uh, Ur, Uh, Xu, Xu, Xu, Xu, Xu, Xu, Xu, Xu, Xu, Xu
Xu, Xu, Xu, Xu, Xu, Xu, Xu, Xu, Uu^Vu, Xu, Uu, Uu, Uu, Uu, Uh, Ds, Ww, Ww, Ww, Wwf, Wwf, Ds, Uu, Uu, Uu, Xu, Xu, Xu, Xu, Uu, Uu, Uu, Ur, Ur, Uu, Uu, Xu, Xu, Xu, Xu, Xu, Xu, Xu, Xu, Xu, Xu
Xu, Uu, Uu, Uu, Uu, Urb, Uu, Uu, Uu, Uu, Urb, Uu, Uh, Uh, Uu, Uh, Uh, Uh, Uh, Uh, Ww, Ds, Ur, Uu, Uu, Uu, Uu, Xu, Xu, Uu, Uu, Uu, Ur, Uu, Xu, Xu, Xu, Xu, Xu, Xu, Xu, Xu, Xu, Xu, Xu, Xu
Xu, Uu, Urb, Uu, Uu, Uu, Urb, Uu, Uu, Uu, Uu, Uh, Uh, Urb, Uh, Uh, Uu, Uu, Wwf, Wwf, Ur, Ur, Urb, Ur, Ur, Ur, Ur, Uu, Uu, Xu, Ur, Ur, Uu, Xu, Uu, Xu, Uu, Xu, Uu, Xu, Uu^Vu, Xu, Xu, Xu, Xu, Xu
Urb, Urb, Urb, Urb, Uu, Urb, Urb, Uu, Urb, Urb, Urb, Uh, Uu, Uh, Urb, Uu, Urb, Ww, Wwf, Ur, Uu, Urb, Urb, Uu, Uu, Uu, Uu, Ur, Ur, Ur, Ur, Urb, Uu, Uu, Uu, Uu, Uu, Uu, Uu, Uu, Uu, Uu, Uu, Xu, Xu, Xu
Urb, Urb, Urb, Urb, Urb, Uu, Uu, Uu, Uu, Urb, Urb, Uu, Uu, Uu, Uu, Uu, Uu^Vu, Ww, Qxua, Wwf, Qxua, Urb, Urb, Urb, Uu, Uu, Uu, Uu, Uu, Ur, Ur, Uu, Uh, Uu^Vu, Uh, Uu, Uu, Uu, Uu, Uu, Uh, Uu, Uu, Uu, Uu, Xu
Urb, Urb, Urb, Urb, Urb, Urb, Urb, Uu, Uu, Urb, Urb, Uu, Urb, Urb, Urb, Urb, Qxua, Qxua, Qxua, Qxua, Qxua, Qxua, Urb, Urb, Uu^Vu, Uu, Uu, Uh, Uh, Uh, Uh, Ur, Uh, Uh, Uh, Uh, Uh, Uu, Uh, Uh, Uu, Uu, Uu, Uu, Uu, Uu
Urb, Urb, Ce, Urb, Urb, Urb, Urb, Urb, Urb, Urb, Uu, Uu, Urb, Urb, Urb, Urb, Qxu^Bcx\, Qxua, Qxua, Qxua, Qxua, Qxua, Qxu^Bcx/, Urb, Urb, Uu, Uu, Uu, Uh, Uh, Uh, Ur, Uh, Uh, Uh, Uh, Ur, Uu, Uu, Uh, Uu, Uu, Chr, Uu, Uu, Uu
Urb, Urb, 1 Ke, Ce, Urb, Urb, Urb, Urb, Urb, Urb, Uu, Urb, Uu, Uu, Uu, Urb, Qxua, Qxu^Bcx\, Urb, Urb, Urb, Qxu^Bcx/, Qxua, Urb, Urb, Uh, Uu, Uu, Uu, Uh, Uu, Ur, Ur, Ur, Ur, Ur, Ur, Ur, Uh, Uh, Uu, Chr, 2 Khr, Chr, Uu, Uu
Urb, Urb, Ce, Ce, Urb, Urb, Urb, Urb, Urb, Urb, Uu, Urb, Uu, Uu, Uu, Urb, Qxu^Bcx/, Qxu^Bcx/, Qxua, Urb^Vud, Qxua, Qxu^Bcx\, Qxu^Bcx\, Urb, Urb, Uh, Uh, Uu, Uu, Uu, Uu, Uu, Urb, Urb, Urb, Urb, Urb, Uh, Uu, Uu, Uu, Chr, Chr, Chr, Uu, Uu
Urb, Urb, Urb, Urb^Vct, Urb, Urb, Urb, Urb, Urb, Urb, Uu^Vu, Urb, Uu, Uu, Uu, Urb, Urb, Qxua, Qxua, Qxua, Qxua, Qxua, Qxua, Urb, Uu, Urb, Uh, Uu, Uu, Uu, Uu, Uu^Vu, Urb, Urb, Urb, Urb, Urb, Urb, Urb, Uu, Uu, Uu, Uu, Uu, Uu, Uu
Urb, Urb, Urb, Urb, Urb, Urb, Urb, Urb, Urb, Urb, Uu, Uu, Uh, Uh, Uu, Urb, Urb, Qxua, Qxua, Qxua, Qxua, Qxua, Urb, Uu, Urb, Uu, Uu, Uu, Uu, Uu, Uu, Urb, Urb, Urb, Urb, Urb, Urb, Urb, Uu, Uu, Uu, Uu, Uu, Uu, Urb, Urb
Urb, Urb, Urb, Urb, Urb, Urb, Urb, Urb, Urb, Uu, Uu, Urb, Uh, Uh, Urb, Uu, Uh, Urb, Uh, Uu, Uh, Uh, Uu, Uu, Urb, Urb, Uu, Uu, Uu, Uu, Uu, Urb, Urb, Urb, Uu, Uu, Uu, Uu, Urb, Uu, Uu, Uu, Uu, Urb, Urb, Urb
Xu, Urb, Urb, Urb, Urb, Urb, Uu, Uu, Uu, Uu, Uu, Urb, Urb, Uh, Uh, Urb, Uh, Uh, Uh, Uh, Urb, Urb, Uu, Uu, Uu, Uu, Urb, Urb, Uu, Uu, Urb, Urb, Urb, Urb, Uu, Urb, Uu, Uu, Xu, Xu, Xu, Uu, Uu, Uu, Uu, Uu
Xu, Xu, Xu, Urb, Urb, Urb, Uu, Uu, Urb, Urb, Xu, Urb, Urb, Uh, Uh, Uh, Urb, Urb, Urb, Urb, Uu, Uu, Uu, Uu, Uu, Urb, Uu, Uu, Uu, Uu, Urb, Urb, Xu, Urb, Uu^Vu, Uu, Xu, Xu, Xu, Xu, Xu, Xu, Xu, Uu, Uu^Vu, Uu
Xu, Xu, Xu, Xu, Xu, Xu, Xu, Xu, Xu, Xu, Xu, Xu, Xu, Urb, Xu, Urb, Urb, Urb, Urb, Uu, Uu, Urb, Xu, Urb, Xu, Uu, Xu, Uu, Xu, Uu, Uu, Uu, Xu, Xu, Xu, Xu, Xu, Xu, Xu, Xu, Xu, Xu, Xu, Xu, Xu, Xu
Xu, Xu, Xu, Xu, Xu, Xu, Xu, Xu, Xu, Xu, Xu, Xu, Xu, Xu, Xu, Xu, Urb, Urb, Uh, Uu^Vu, Uh, Uh, Xu, Xu, Xu, Xu, Xu, Xu, Xu, Uu, Uu, Uu, Xu, Xu, Xu, Xu, Xu, Xu, Xu, Xu, Xu, Xu, Xu, Xu, Xu, Xu
Xu, Xu, Xu, Xu, Xu, Xu, Xu, Xu, Xu, Xu, Xu, Xu, Xu, Xu, Xu, Xu, Uh, Uh, Uh, Uh, Uh, Uh, Xu, Xu, Xu, Xu, Xu, Xu, Xu, Xu, Xu, Uu, Xu, Xu, Xu, Xu, Xu, Xu, Xu, Xu, Xu, Xu, Xu, Xu, Xu, Xu
Xu, Xu, Xu, Xu, Xu, Xu, Xu, Xu, Xu, Xu, Xu, Xu, Xu, Xu, Xu, Xu, Xu, Uh, Xu, Xu, Xu, Xu, Xu, Xu, Xu, Xu, Xu, Xu, Xu, Xu, Xu, Xu, Xu, Xu, Xu, Xu, Xu, Xu, Xu, Xu, Xu, Xu, Xu, Xu, Xu, Xu
Xu, Xu, Xu, Xu, Xu, Xu, Xu, Xu, Xu, Xu, Xu, Xu, Xu, Xu, Xu, Xu, Xu, Xu, Xu, Xu, Xu, Xu, Xu, Xu, Xu, Xu, Xu, Xu, Xu, Xu, Xu, Xu, Xu, Xu, Xu, Xu, Xu, Xu, Xu, Xu, Xu, Xu, Xu, Xu, Xu, Xu
Xu, Xu, Xu, Xu, Xu, Xu, Xu, Xu, Xu, Xu, Xu, Xu, Xu, Xu, Xu, Xu, Xu, Xu, Xu, Xu, Xu, Xu, Xu, Xu, Xu, Xu, Xu, Xu, Xu, Xu, Xu, Xu, Xu, Xu, Xu, Xu, Xu, Xu, Xu, Xu, Xu, Xu, Xu, Xu, Xu, Xu
Xu, Xu, Xu, Xu, Xu, Xu, Xu, Xu, Xu, Xu, Xu, Xu, Xu, Xu, Xu, Xu, Xu, Xu, Xu, Xu, Xu, Xu, Xu, Xu, Xu, Xu, Xu, Xu, Xu, Xu, Xu, Xu, Xu, Xu, Xu, Xu, Xu, Xu, Xu, Xu, Xu, Xu, Xu, Xu, Xu, Xu
Xu, Xu, Xu, Xu, Xu, Xu, Xu, Xu, Xu, Xu, Xu, Xu, Xu, Xu, Xu, Xu, Xu, Xu, Xu, Xu, Xu, Xu, Xu, Xu, Xu, Xu, Xu, Xu, Xu, Xu, Xu, Xu, Xu, Xu, Xu, Xu, Xu, Xu, Xu, Xu, Xu, Xu, Xu, Xu, Xu, Xu
Xu, Xu, Xu, Xu, Xu, Xu, Xu, Xu, Xu, Xu, Xu, Xu, Xu, Xu, Xu, Xu, Xu, Xu, Xu, Xu, Xu, Xu, Xu, Xu, Xu, Xu, Xu, Xu, Xu, Xu, Xu, Xu, Xu, Xu, Xu, Xu, Xu, Xu, Xu, Xu, Xu, Xu, Xu, Xu, Xu, Xu
