Rd, Rd, Gd, Gd, Gd, Gd, Gd, Gd, Gd, Gd, Gd, Gd, Gd, Gd, Gd, Gd, Gd, Gd, Gd, Gd, Gd, Gd, Gd, Gd, Gd, Gd, Gd, Gd, Gd, Gd, Gd, Gd, Gd, Gd, Gd, Gd, Gd, Gd, Gd, Gd, Hhd^Fdw, Hhd^Fdw, Hhd^Fdw, Hhd^Fdw, Hhd^Fdw, Gd, Hhd^Fdw, Gd, Gd, Gd, Gd, Gd, Gd, Gd, Gd, Gd, Gd, Gd, Gd, Gd, Gd, Gd
Gd, Rd, Rd, Rd, Rd, Gd, Gd^Fdf, Hhd^Fdf, Hhd^Fdf, Hhd, Hhd, Gd, Gd, Gd, Gd, Gd, Gd, Gd, Gd, Gd, Gd, Gd, Gd, Gd, Gd, Gd, Gd^Fetd, Gd, Qxu, Qxu, Qxu, Qxu, Gd, Gd, Gd, Gd, Gd^Fdw, Gd, Hhd^Fdw, Hhd^Fdw, Hhd^Fdw, Hhd^Fdw, Hhd^Fdw, Hhd^Fdw, Hhd^Fdw, Hhd^Fdw, Hhd^Fdw, Hhd^Fdw, Gd, Gd, Md, Gd, Hhd, Hhd, Hhd, Gd, Gd^Fdw, Gd, Gd, Gd, Gd, Gd
Gd, Gd, Gd, Gd, Gd, Rd, Rd, Hhd^Fdw, Hhd^Fdw, Hhd^Fdf, Hhd, Hhd, Gd, Gd, Gd, Gd, Gd, Gd, Gd, Gd, Gd, Gd, Gd, Gd, Gd, Gd, Gd, Qxu, Qxu, Gd, Gd, Gd, Gd, Gd, Gd, Gd^Fdw, Hhd^Fdw, Hhd^Fdw, Hhd^Fdw, Hhd^Fdw, Hhd^Fdw, Hhd^Fdw, Hhd^Fdw, Hhd^Fdw, Hhd^Fdw, Hhd^Fdw, Hhd^Fdw, Hhd^Fdw, Md, Md, Md, Md, Hhd, Hhd, Hhd^Fdw, Hhd^Fdw, Gd^Fdw, Gd^Fdw, Gd, Gd, Gd, Gd
Gd, Gd, Gd, Gd, Gd, Gd, Gd^Fdw, Rd, Rd, Hhd^Fdf, Rd, Hhd^Vhhr, Rd, Gd, Gd, Gd, Gd, Gd, Gd, Gd, Md, Md, Md, Gd, Gd, Gd, Gd, Qxu, Qxu, Gd, Gd, Gd, Gd, Gd, Gd, Hhd^Fdw, Hhd^Fdw, Hhd^Fdw, Hhd^Fdw, Hhd^Fdw, Md, Md, Md, Md, Md, Hhd^Fdw, Md, Md, Md, Md, Md, Md, Md, Hhd, Hhd^Fdw, Hhd^Fdw, Hhd^Fdw, Gd^Fdw, Gd, Gd, Gd, Gd
Gd, Gd, Gd, Gd, Gd^Fdw, Gd^Fdw, Gd^Fdw, Gd^Fdw, Gd, Rd, Cvr, Rd, Cvr, Rd, Rd, Gd, Gd, Gd, Gd, Md, Md, Md, Md, Gd, Gd, Gd, Gd, Gd, Gd, Qxu, Gd, Gd, Gd, Gd, Gd, Hhd^Fdw, Hhd^Fdw, Hhd^Fdw, Hhd, Md, Md, Md, Md, Md, Md, Md, Md, Md, Md, Mv, Md, Md, Md, Hhd^Fdw, Hhd^Fdw, Hhd^Fdw, Hhd^Fdw, Gd, Gd, Gd, Gd, Gd
Gd^Fdf, Gd^Fdf, Gd^Fdf, Gd^Fdf, Gd^Fdw, Gd^Fdw, Gd, Gd, Gd, Gd, Cvr, 5 Kvr, Cvr, Gd, Gd, Rd, Rd, Gd, Gd, Md, Md, Md, Md, Md, Qlf, Gd, Gd, Gd, Gd, Qxu, Qxu, Gd, Gd, Gd, Gd, Gd^Fdw, Hhd^Fdw, Hhd^Fdw, Hhd, Md, Md, Md, Md, Md, Sm, Wwf, Md, Qlf, Qlf, Md, Md, Md, Md, Hhd^Fdw, Hhd^Fdw, Hhd^Fdw, Hhd, Gd, Gd, Gd, Gd, Gd
Gd^Fdf, Gd^Fdf, Gd^Fdf, Gd^Fdw, Gd^Fdw, Gd, Gd, Gd, Gd, Gd, Gd, Cvr, Gd, Gd, Qxu, Gd, Rd, Gd, Qlf, Qlf, Qlf, Md, Mv, Md, Qlf, Gd, Qlf, Qxu, Gd^Vhr, Gd, Qxu, Gd, Gd, Gd, Gd, Gd^Fdw, Hhd^Fdw, Hhd^Fdw, Hhd, Md, Md, Md, Sm, Sm, Wwf, Md, Md, Md, Md, Qlf, Qlf, Md, Md, Hhd^Fdw, Hhd^Fdw, Hhd^Fdw, Hhd^Fdw, Gd, Gd, Gd, Gd, Gd
Gd^Fdf, Gd^Fdf, Gd^Fdw, Gd^Fdw, Gd, Gd, Gd, Gd, Gd, Gd, Gd, Gd, Qxu, Qxu, Gd, Gd, Rd, Rd, Gd, Qlf, Qlf, Md, Md, Md, Qlf, Qlf, Qlf, Qxu, Qxu, Qxu, Gd, Gd, Gd, Gd, Gd, Gd^Fdw, Hhd^Fdw, Hhd^Fdw, Hhd, Hhd, Md, Md, Wwf, Wwf, Sm, Md, Hhd, Md, Qlf, Qlf, Qlf, Md, Md^Fdw, Hhd^Fdw, Hhd^Fdw, Hhd^Fdw, Hhd^Fdw, Gd, Gd, Gd, Gd, Gd
Gd^Fdw, Gd^Fdw, Gd^Fdw, Gd, Gd, Gd, Gd, Gd, Gd, Gd, Gd, Qxu, Gd, Gd, Gd, Gd, Hhd^Vhhr, Rd, Qlf, Qlf, Qlf, Qlf, Qlf, Qlf, Qlf, Qlf, Qlf, Qxu, Qxu, Gd, Gd, Gd, Gd, Gd, Gd, Gd^Fdw, Gd^Fdw, Hhd^Fdw, Hhd^Fdw, Hhd^Fdw, Gll^Fdf, Md^Vhhr, Wwf, Sm^Vm, Hhd^Fdw, Hhd, Hhd^Fdw, Hhd^Fdw, Hhd^Fdw, Qlf, Qlf, Qlf, Gd^Fdw, Hhd^Fdw, Hhd^Fdw, Hhd^Fdw, Gd^Fdw, Gd, Gd, Gd, Gd, Gd
Gd^Fdw, Gd^Fdw, Gd^Fdw, Gd, Gd, Gd, Qxu, Qxu, Qxu, Gd^Vhr, Qxu, Qxu, Gd, Gd, Gd, Gd, Hhd, Rd, Rd, Qlf, Qlf, Qlf, Qlf, Qlf, Qlf, Qlf, Qxu, Qxu, Gd, Gd, Gd, Gd, Gd, Gd, Gd, Gd^Fdw, Gd^Fdw, Gd^Fdw, Gd^Fdw, Gll^Fdf, Gll^Fdf, Gd^Fdw, 4 Kme, Hhd^Fdw, Hhd^Fdw, Hhd^Fdw, Hhd^Fdw, Hhd^Fdw, Hhd^Fdw, Qlf, Qlf, Qlf, Qlf, Gd^Fdw, Qlf, Gd^Fdw, Gd^Fdw, Gd, Gd, Gd, Gd, Gd
Hhd^Fdw, Hhd^Fdw, Gd, Gd, Gd, Gd, Qxu, Gd^Vhr, Gd, Qxu, Gd, Gd, Gd, Gd, Gd^Fdf, Hhd^Fdf, Hhd^Fdf, Hhd^Fdf, Hhd^Fdf, Rd, Rd, Rd, Rd, Qlf, Qlf, Qlf, Gd, Gd, Gd, Gd, Gd, Gd, Gd, Gd, Gd, Gd^Fdw, Gd^Fdw, Gd^Fdw, Gll^Fdf, Gll^Fdf, Gll^Fdf, Cme, Cme, Gll^Fdf, Gd^Fdw, Hhd^Fdw, Gd^Fdw, Hhd^Fdw, Gd^Fdw, Gd^Fdw, Gd^Fdw, Qlf, Qlf, Qlf, Qlf, Gd^Fdw, Qlf, Gd, Gd, Gd, Gd, Gd
Hhd, Hhd, Gd, Gd, Qxu, Qxu, Gd, Gd, Gd, Gd, Gd, Gd, Gd, Gd, Gd, Gd^Fdf, Hhd^Fdw, Hhd^Fdf, Hhd^Fdw, Hhd, Gd, Rd, Rd, Qlf, Gd, Gd, Gd, Gd, Gd, Gd, Gd, Gd, Gd, Gd, Gd, Gd, Gd^Fdw, Gd^Fdw, Gll^Fdf, Gll^Fdf, Gll^Fdf, Cme, Gll^Fdf, Gll^Fdf, Gd^Fdw, Gd^Fdw, Gd^Fdw, Gd^Fdw, Gd^Fdw, Gd^Fdw, Gd^Fdw, Gd^Fdw, Qlf, Qlf, Qlf, Qlf, Qlf, Gd, Gd, Gd, Gd, Gd
Hhd, Hhd, Qxu, Qxu, Gd, Gd, Gd, Gd, Gd, Gd, Gd, Gd, Gd, Gd, Gd, Gd^Fdw, Gd^Fdw, Hhd^Fdw, Hhd^Fdw, Hhd, Hhd, Gd, Gd, Rd, Gd, Gd, Gd, Gd, Gd, Gd, Gd, Gd, Gd, Gd, Gd, Gd^Fdw, Gll^Fdf, Gll^Fdf, Gll^Fdf, Gll^Fdf, Gll^Fdf, Wwf^Vm, Gll^Fdf, Gd^Fdw, Gd^Fdw, Gd^Fdw, Gd^Fdw, Gd^Fdw, Gd^Fdw, Gd^Fdw, Gd^Fdw, Gd^Fdw, Gd^Fdw, Qlf, Qlf, Qlf, Qlf, Gd, Gd, Gd, Gd, Gd
Gd, Gd, Gd, Gd, Gd, Gd, Gd, Gd, Gd, Gd, Gd, Gd, Gd, Gd, Gd, Gd, Gd^Fdw, Gd^Fdw, Gd, Gd, Gd, Gd, Gd, Rd, Rd, Gd, Gd, Gd, Gd, Gd, Gd, Gd, Gd, Gd, Gd, Gd^Fdw, Gd^Fdw, Gll^Fdf, Gll^Fdf, Gll^Fdf, Gll^Fdf, Wwf, Gd^Fdw, Gll^Fdf, Gd^Fdw, Gd^Fdw, Gd^Fdw, Gd^Fdw, Gd^Fdw, Gd^Fdw, Gd^Fdw, Gd^Fdw, Gd^Fdw, Gd, Gd, Qlf, Gd, Gd, Gd, Gd, Gd, Gd
Hhd, Gd, Hhd^Fdw, Gd, Gd^Fdw, Gd, Gd^Fdw, Gd, Gd, Gd, Gd, Gd, Gd, Gd, Gd, Gd, Gd, Gd, Gd, Gd, Gd, Gd, Gd, Gd, Gd, Rd, Rd, Gd, Gd, Gd, Qxu, Gd, Gd, Gd, Gd, Gd, Gd, Gll^Fdf, Wwf, Wwf, Sm, Wwf, Gll^Fdf, Gll^Fdf, Gd^Fdw, Gd^Fdw, Gd^Fdw, Gd^Fdw, Gd^Fdw, Gd^Fdw, Gd^Fdw, Gd^Fdw, Gd^Fdw, Gd, Gd, Gd, Gd, Gd, Gd, Gd, Gd, Gd
Hhd, Hhd, Hhd^Fdw, Hhd^Fdw, Hhd^Fdw, Gd^Fdw, Hhd^Fdw, Gd^Fdw, Gd, Gd, Gd, Gd, Gd, Gd, Gd, Gd, Gd, Gd, Gd, Gd, Gd, Gd, Gd, Gd, Chr, Rd, Rd, Gd, Qxu, Qxu, Gd, Gd, Gd, Gd, Gd, Gd, Gd, Gd, Wwf, Sm, Gll^Fdf, Sm, Gll^Fdf, Gd^Fdw, Gd^Fdw, Gd^Fdw, Gd, Gd^Fdw, Gd, Gd, Gd, Gd^Fdw, Gd, Gd, Gd, Gd, Gd, Gd, Gd, Gd, Gd, Gd
Hhd, Hhd, Hhd, Hhd^Fdw, Hhd^Fdw, Hhd^Fdw, Hhd, Hhd, Hhd^Vhhr, Gd, Gd, Gd, Gd, Gd, Gd, Gd, Gd, Gd, Gd, Gd, Gd, Gd, Chr, Chr, Qxu, Qxu, Qxu, Qxu, Qxu, Qxu, Gd, Gd, Gd, Gd, Gd, Gd, Gd, Gd, Wwf, Sm, Gd, Gd, Gd, Gd, Qxu, Gd, Qxu, Gd, Qxu, Gd, Qxu, Gd, Gd, Gd, Gd, Gd, Gd, Gd, Gd, Gd, Gd, Gd
Md, Hhd, Md, Hhd, Hhd, Hhd, Hhd, Hhd, Hhd, Gd, Gd, Gd, Gd, Gd, Gd, Gd, Gd, Gd, Gd, Gd, Gd, Chr, Qxu, Qxu, Qxu, Chr, Rd, Gd^Fetd, Gd, Gd, Gd, Gd, Gd, Gd, Sm, Sm, Wwf, Wwf, Gd, Gd, Gd, Gd, Qxu, Qxu, Gd, Qxu, Qxu, Qxu, Gd, Qxu, Gd^Vhr, Qxu, Gd, Gd, Gd, Gd, Gd, Gd, Gd, Gd, Gd, Gd
Md, Md, Md, Md, Md, Hhd, Hhd, Hhd, Qlf, Gd, Gd, Gd, Gd, Gd, Gd, Gd, Gd, Gd, Gd, Gd, Gd, 3 Khr, Chr, Chr, Chr, Chr, Rd, Gd, Gd, Gd, Gd, Gd, Hhd, Sm, Gd, Wwf, Gd, Gd, Gd, Gd, Qxu, Qxu, Gd, Gd, Gll^Fdw, Gd, Gll^Fdw, Gd, Gll^Fdw, Gd, Gd, Gd, Gd, Gd, Gd, Gd, Gd, Gd, Gd, Gd, Gd, Gd
Md^Xm, Md, Md, Md, Qlf, Qlf, Qlf, Qlf, Qlf, Qlf, Qlf, Qlf, Gd, Gd, Gd, Gd, Gd, Gd, Gd, Gd, Gd, Gd, Gd, Gd, Gd, Gd, Rd, Gd, Gd, Gd, Hhd, Hhd, Hhd, Sm, Wwf, Gd, Gd, Gd, Qxu, Qxu, Gd, Qxu, Gll^Fdw, Gll^Fdw, Gll^Fdw, Gll^Fdw, Gll^Fdw, Gll^Fdw, Gll^Fdw, Gd, Gd, Gd, Gd, Gd, Gd, Gd, Gd, Gd, Gd, Gd, Gd, Gd
Md^Xm, Md^Xm, Md^Xm, Md, Qlf, Qlf, Qlf, Qlf, Qlf, Qlf, Qlf, Qlf, Qlf, Gd, Gd, Gd, Gd, Gd, Gll^Fdw, Gll^Fdw, Gll^Fdw, Gd, Gll^Fdw, Gll^Fdw, Gd, Gd, Gd, Rd, Rd, Gd, Hhd, Hhd, Hhd, Hhd, Wwf, Gd, Gd, Gd, Qxu, Gd, Gd, Gd, Gll^Fdw, Gll^Fdw, Gll^Fdw, Gll^Fdw, Gll^Fdw, Gll^Fdw, Qlf, Gd, Gd, Gd, Gd, Gd, Gd, Gd, Gd, Gd, Gd, Gd, Gd, Gd
Md^Xm, Md^Xm, Md^Xm, Qlf, Qlf, Qlf, Qlf, Qlf, Qlf, Qlf, Qlf, Qlf, Gd, Gd, Gd, Gd, Gll^Fdw, Gll^Fdw, Gll^Fdw, Gll^Fdw, Gll^Fdw, Gll^Fdw, Gll^Fdf, Gd, Gd, Gd, Gd, Gd, Rd, Gd, Hhd^Vhhr, Hhd, Wwf, Hhd, Wwf, Gd, Gd, Gd, Gd, Gd, Gd, Gll^Fdw, Gll^Fdw, Gll^Fdw, Qlf, Qlf, Qlf, Qlf, Qlf, Qlf, Gd, Gd, Gd, Gd, Gd, Gd, Gd, Gd, Gd, Gd, Gd, Gd
Md^Xm, Md^Xm, Md^Xm, Qlf, Qlf, Qlf, Qlf, Qlf, Hhd^Fdw, Gd^Fdw, Gd^Fdw, Gd, Gd^Fdw, Gd, Gd, Gd, Gll^Fdw, Gll^Fdw, Gll^Fdw, Gll^Fdw, Gll^Fdf, Gll^Fdf, Gll^Fdf, Gd, Gg, Gd, Gg, Gd, Gd, Rd, Wwf^Bw\, Wwf, Gd, Wwf, Gd, Gd, Gll^Fdw, Gll^Fdw, Gll^Fdw, Gd, Gd, Gd, Gd, Qlf, Qlf, Qlf, Ql, Ql, Ql, Qlf, Qlf, Gd, Gd, Gd, Gd, Gd, Gd, Gd, Gd, Gd, Gd, Gd
Md^Xm, Md^Xm, Qlf, Qlf, Qlf, Qlf, Hhd^Fdw, Hhd^Fdw, Hhd^Fdw, Gd^Fdw, Gd^Fdw, Gd^Fdw, Gd^Fdw, Gd^Fdw, Gd^Fdw, Gd, Gll^Fdw, Gll^Fdf, Gll^Fdf, Gll^Fdf, Gll^Fdf, Gll^Fdf, Hh^Fds, Hh^Fdf, Gs^Fds, Gs^Fds, Wwf, Gg, Wwf, Wwf, Gd, Rd, Rd, Gd, Gll^Fdw, Gll^Fdw, Sm, Gll^Fdf, Gll^Fdw, Gd, Gd, Gd, Qlf, Qlf, Qlf, Ql, Ql, Ql, Qlf, Qlf, Gd, Gd, Gd, Gd, Gd, Gd, Gd, Gd, Gd, Gd, Gd, Gd
Qlf, Qlf, Qlf, Qlf, Qlf, Qlf, Hhd, Hhd^Fdw, Hhd^Fdw, Hhd^Fdw, Gd^Fdw, Gd^Fdw, Gd^Fdw, Gd^Fdw, Qxu, Gll^Fdw, Gll^Fdw, Gll^Fdw, Gll^Fdf, Gll^Fdf, Gll^Fdf, Hh^Fdf, Hh^Fdf, Hh^Fds, Wwf, Wwf, Ww, Wwf, Gg, Gd, Gd, Gd, Gd, Rd, Rd, Sm, Sm, Gll^Fdf, Cvr, Gd, Gll^Fdw, Gd, Gd, Qlf, Qlf, Qlf, Qlf, Ql, Qlf, Gd, Gd, Gd, Gd, Gd, Gd, Gd, Gd, Gd, Gd, Gd, Gd, Gd
Qlf, Qlf, Qlf, Qlf, Qlf, Qlf, Md, Hhd^Fdw, Hhd^Fdw, Hhd^Fdw, Gd^Fdw, Gd^Fdw, Qxu, Qxu, Gd^Fdw, Qxu, Gll^Fdw, Gll^Fdw, Gll^Fdf, Gll^Fdf, Gll^Fdf, Gs^Fds, Gll^Fdf, Gll^Fdf, Wwf, Ww, Wwr^Vm, Ww, Wwf, Gg, Gd, Gd, Gd, Gd, Gll^Fdw, Rd, Rd, Cvr, 2 Kvr, Cvr, Sm, Gll^Fdw, Gd, Gd, Gd, Gd, Gd, Gd, Gd, Gd, Gd, Gd, Gd, Gd, Gd, Gd, Gd, Gd, Gd, Gd, Gd, Gd
Qlf, Qlf, Qlf, Qlf, Md, Md, Md, Hhd, Hhd^Fdw, Hhd^Fdw, Hhd^Fdw, Gd^Fdw, Qxu, Gd^Fdw, Gd^Fdw, Gd^Fdw, Gll^Fdw, Gll^Fdw, Gll^Fdw, Gll^Fdf, Gll^Fdf, Gg, Gs^Fds, Wwf, Ww, Ww, Ww, Gg^Vc, Wwf, Gg, Gll^Fdf, Gd, Gd, Gll^Fdw, Gll^Fdf, Sm, Sm, Rd, Cvr, Cvr, Sm, Sm, Gll^Fdw, Gd, Gd, Gd, Gd, Gd, Gd, Gd, Gd, Gd, Gd, Gd, Gd, Gd, Gd, Gd, Gd, Gd, Gd, Gd
Md^Xm, Qlf, Mv, Md^Xm, Md, Md, Md, Hhd, Hhd^Fdw, Hhd^Fdw, Hhd^Fdw, Qxu, Gd^Fdw, Gd^Fdw, Gd^Fdw, Gd^Fdw, Gd, Gll^Fdw, Gll^Fdw, Gll^Fdf, Gll^Fdf, Gd, Wwf, Wwf, Wwf, Wwf, Wwf, Wwf, Gs^Fds, Gg, Gll^Fdf, Gd, Gd, Gll^Fdw, Gll^Fdf, Sm, Gll^Fdf, Rd, Gll^Fdf, Gll^Fdf, Gll^Fdf, Gll^Fdf, Gll^Fdw, Gd, Gd, Gd, Gd, Gd, Gd, Gd, Gd, Gd, Gd, Gd, Gd, Gd, Gd, Gd, Hhd^Vhhr, Gd, Gd, Gd
Md^Xm, Md^Xm, Md^Xm, Md^Xm, Md^Xm, Md, Md, Md, Hhd, Hhd^Fdw, Hhd^Fdw, Hhd^Fdw, Gd^Fdw, Gd^Fdw, Gd^Fdw, Gd, Gd, Gll^Fdw, Gd, Gd, Wwf, Wwf, Wwf, Gg, Gg, Gs^Fds, Hh^Fds, Gs^Fds, Gs^Fds, Gll^Fdf, Gd, Gd, Gd, Gll^Fdw, Gll^Fdw, Gll^Fdw, Gll^Fdw, Rd, Rd, Gll^Fdf, Gll^Fdw, Gll^Fdw, Gd, Gd, Gd, Gd, Gd, Gd, Gd, Gd, Gd, Gd, Gd^Fdw, Gd^Fdw, Gd^Fdw, Gd^Fdw, Hhd^Fdw, Hhd, Hhd, Hhd, Md, Gd
Md^Xm, Md^Xm, Md^Xm, Md^Xm, Md^Xm, Md^Xm, Md, Md, Md, Hhd^Fdw, Hhd^Fdw, Hhd^Fdw, Hhd^Fdw, Gd^Fdw, Gd^Fdw, Gd, Gd, Gd, Sm, Wwf, Sm, Sm, Wwf, Hh, Hh, Hh^Fdf, Hh^Fdf, Gs^Fds, Gll^Fdf, Gll^Fdf, Gd, Gd, Gd, Gd, Gd, Gd, Gd, Gd, Gd, Rd, Rd, Rd, Rd, Gd, Gd, Gd, Gd^Vhr, Gd, Gd, Gd, Gd, Gd, Gd^Fdw, Gd^Fdw, Hhd^Fdw, Hhd^Fdw, Hhd^Fdw, Hhd, Hhd, Hhd, Md, Md
Md^Xm, Md^Xm, Md^Xm, Md^Xm, Mv, Md^Xm, Md, Md, Md, Hhd^Fdw, Hhd^Fdw, Hhd^Fdw, Hhd^Fdw, Gd^Fdw, Gd, Gd, Gd, Gd, Sm, Sm, Sm, Wwf, Hhd, Hh, Hh, Hh^Fdf, Hh^Fdw, Gll^Fdf, Gll^Fdw, Gd, Gd, Gd, Gd, Gd, Gd, Gd, Gd, Gd, Gd, Gd, Gd, Gd, Gd, Rd, Rd, Rd, Gd, Gd, Gd, Gd, Gd, Gd^Fdw, Gd^Fdw, Hhd^Fdw, Hhd^Fdw, Hhd^Fdw, Hhd, Hhd, Md, Md, Md, Md
Md^Xm, Md^Xm, Md^Xm, Md^Xm, Md^Xm, Md^Xm, Md, Md, Md, Md, Hhd^Fdw, Hhd^Fdw, Hhd^Fdw, Hhd^Fdw, Md, Gd, Gd, Gd, Wwf, Sm, Wwf, Wwf, Gd, Hhd, Gd, Gll^Fdf, Gll^Fdf, Gll^Fdw, Gd, Gd, Gd, Gd, Gd, Gd, Gd, Gd, Gd, Gd, Gd, Gd, Gd, Gd, Gd, Gd, Gd, Rd, Rd, Gd, Gd, Gd, Gd^Fdw, Gd^Fdw, Hhd^Fdw, Hhd^Fdw, Hhd^Fdw, Hhd, Hhd, Md, Md, Md, Md, Md^Xm
Md^Xm, Md^Xm, Md^Xm, Md^Xm, Md^Xm, Md^Xm, Md^Xm, Md, Md, Md, Md, Hhd^Fdw, Hhd^Fdf, Hhd^Fdw, Hhd^Fdf, Md^Vhhr, Wwf, Wwf, Gd^Fdf, Gd^Fdf, Gd^Fdf, Gd, Gd, Gd, Gd, Gll^Fdf, Gll^Fdw, Gll^Fdw, Gll^Fdw, Gd, Gd, Gd, Gd^Fdw, Gd, Gd, Gd, Gd, Gd, Gd, Gd, Gd, Gd, Gd^Fdw, Gd, Gd, Gd, Rd, Rd, Rd, Gd, Gd^Fdw, Gd^Fdw, Hhd^Fdw, Hhd^Fdw, Hhd^Fdw, Hhd, Md, Md, Md, Md, Md^Xm, Md^Xm
Md^Xm, Md^Xm, Md^Xm, Md^Xm, Qxu, Qxu, Qxu, Md^Xm, Md^Xm, Md, Md, Hhd, Hhd^Fdf, Hhd^Fdf, Wwf, Wwf, Md, Gd^Fdf, Gd^Fdf, Gd^Fdf, Gd^Fdf, Gd^Fdf, Gd, Gd, Gd, Gll^Fdf, Gll^Fdw, Gll^Fdw, Gll^Fdw, Gll^Fdw, Gd^Fdw, Gd^Fdw, Gd^Fdw, Gd^Fdw, Gd^Fdw, Gd^Fdw, Gd^Fdw, Gd, Gd, Gd, Qlf, Gd^Fdw, Gd^Fdw, Gd^Fdw, Gd^Fdw, Gd^Fdw, Gd^Fdw, Rd, Rd, Gd^Fdw, Gd^Fdw, Gd^Fdw, Hhd^Fdw, Hhd^Fdw, Hhd^Fdw, Hhd, Md, Md, Qlf, Md^Xm, Mv, Md^Xm
Md^Xm, Md^Xm, Qxu, Qxu, Qxu, Qxu, Md^Xm, Md^Xm, Md^Xm, Md^Xm, Md^Xm, Md^Xm, Hhd^Fdf, Hhd^Fdf, Wwf, Wwf, Hhd^Fdf, Md, Hhd^Fdf, Gd^Fdf, Hhd^Fdf, Gd^Fdf, Hhd^Fdf, Gd^Fdf, Hhd^Fdf, Gd^Fdf, Hhd^Fdf, Gll^Fdw, Hhd^Fdw, Gd^Fdw, Hhd^Fdw, Gd^Fdw, Hhd^Fdw, Gd^Fdw, Hhd^Fdw, Gd^Fdw, Hhd^Fdw, Gd^Fdw, Hhd^Fdw, Gd^Fdw, Qlf, Gd^Fdw, Qlf, Gd^Fdw, Gd^Fdw, Gd^Fdw, Gd^Fdw, Gd^Fdw, Rd, Gd^Fdw, Rd, Gd^Fdw, Hhd^Fdw, Hhd^Fdw, Qlf, Qlf, Qlf, Qlf, Qlf, Qlf, Md^Xm, Md^Xm
Md^Xm, Md^Xm, Qxu, Qxu, Md^Xm, Md^Xm, Md^Xm, Md^Xm, Md^Xm, Md^Xm, Sm, Md^Xm, Wwf, Hhd^Fdf, Wwf, Hhd^Fdf, Hhd^Fdf, Hhd^Fdf, Hhd^Fdf, Hhd^Fdf, Hhd^Fdf, Hhd^Fdf, Hhd^Fdf, Hhd^Fdf, Hhd^Fdf, Hhd^Fdf, Hhd^Fdf, Hhd^Fdw, Hhd^Fdw, Hhd^Fdw, Hhd^Fdw, Hhd^Fdw, Hhd^Fdw, Hhd^Fdw, Hhd^Fdw, Hhd^Fdw, Hhd^Fdw, Hhd^Fdw, Hhd^Fdw, Hhd^Fdw, Hhd^Fdw, Qlf, Hhd, Hhd^Fdw, Hhd^Fdw, Hhd^Fdw, Hhd^Fdw, Hhd^Fdw, Hhd^Fdw, Rd, Gd^Fdw, Rd, Hhd^Fdw, Hhd^Fdw, Hhd, Qlf, Md, Md, Md^Xm, Qlf, Qlf, Md^Xm
Md^Xm, Md^Xm, Qxu, Md^Xm, Md^Xm, Md^Xm, Md^Xm, Md^Xm, Wwf, Sm, Wwf, Sm, Wwf, Wwf, Wwf, Hhd^Fdf, Hhd^Fdf, Hhd^Fdf, Hhd^Fdf, Hhd^Fdf, Hhd, Hhd^Fdw, Hhd^Fdf, Hhd^Fdw, Hhd^Fdw, Hhd^Fdw, Hhd^Fdw, Hhd^Fdw, Hhd, Hhd^Fdw, Hhd^Fdw, Hhd^Fdw, Hhd^Fdw, Hhd^Fdw, Hhd, Hhd, Hhd, Hhd^Fdw, Hhd^Fdw, Hhd^Fdw, Hhd, Qlf, Qlf, Hhd, Hhd, Hhd, Hhd^Fdw, Hhd^Fdw, Hhd^Fdw, Hhd^Fdw, Hhd^Fdw, Rd, Hhd^Vhhr, Hhd, Qlf, Qlf, Mv, Md, Md^Xm, Md^Xm, Md^Xm, Md^Xm
Md^Xm, Md^Xm, Qxu, Qxu, Qxu, Qxu, Qxu, Qxu, Wwf, Wwf, Wwf, Wwf, Md^Xm, Wwf, Md^Xm, Md^Xm, Md^Xm, Hhd, Md, Hhd^Fdf, Md, Hhd^Fdw, Md, Hhd^Fdw, Md, Hhd^Fdw, Md, Hhd, Md, Hhd, Md, Hhd^Fdw, Md, Hhd, Md, Hhd, Md, Hhd, Md, Hhd, Qlf, Qlf, Qlf, Hhd, Hhd, Hhd, Hhd, Hhd^Fdw, Hhd^Fdw, Hhd^Fdw, Hhd, Rd, Rd, Hhd, Qlf, Md, Md, Md, Md^Xm, Md^Xm, Md^Xm, Md^Xm
Md^Xm, Md^Xm, Md^Xm, Qxu, Qxu, Qxu, Qxu, Qxu, Qxu, Wwf, Md^Xm, Md^Xm, Md^Xm, Md^Xm, Md^Xm, Md^Xm, Md^Xm, Md^Xm, Md^Xm, Md, Md^Xm, Md, Md^Xm, Md, Md, Md, Md, Md, Md, Md, Md, Md, Md, Md, Md, Md, Md, Md, Md, Md, Md, Mv, Md, Md, Md, Md, Md, Hhd, Hhd, Hhd, Ce, Rd, Rd, Hhd, Qlf, Qlf, Qlf, Md, Md^Xm, Md^Xm, Md^Xm, Md^Xm
Md^Xm, Md^Xm, Md^Xm, Md^Xm, Qxu, Qxu, Qxu, Qxu, Qxu, Md^Xm, Md^Xm, Md^Xm, Md^Xm, Mv, Md^Xm, Md^Xm, Md^Xm, Md^Xm, Md^Xm, Md^Xm, Md^Xm, Md^Xm, Md^Xm, Md^Xm, Md^Xm, Md^Xm, Md^Xm, Md^Xm, Md^Xm, Md^Xm, Md^Xm, Md, Md^Xm, Md, Md^Xm, Md, Md^Xm, Md, Md^Xm, Md, Md^Xm, Md, Md^Xm, Md, Md, Md, Md, Md, Md, Hhd, Ce, Ce, Ce, Rd, Hhd, Hhd, Md, Md, Md^Xm, Md^Xm, Md^Xm, Md^Xm
Md^Xm, Md^Xm, Md^Xm, Md^Xm, Md^Xm, Qxu, Qxu, Qxu, Md^Xm, Md^Xm, Md^Xm, Md^Xm, Md^Xm, Md^Xm, Md^Xm, Md^Xm, Md^Xm, Md^Xm, Md^Xm, Md^Xm, Md^Xm, Md^Xm, Md^Xm, Md^Xm, Md^Xm, Md^Xm, Md^Xm, Md^Xm, Mv, Md^Xm, Md^Xm, Md^Xm, Md^Xm, Md^Xm, Md^Xm, Md^Xm, Md^Xm, Md^Xm, Md^Xm, Md^Xm, Md^Xm, Md^Xm, Md^Xm, Md^Xm, Md^Xm, Md, Md, Md, Md, Hhd, Hhd, Ce, Ce, 1 Ke, Hhd, Hhd, Md, Md, Md, Md^Xm, Md^Xm, Md^Xm
Md^Xm, Md^Xm, Md^Xm, Md^Xm, Md^Xm, Qxu, Md^Xm, Qxu, Md^Xm, Md^Xm, Md^Xm, Md^Xm, Md^Xm, Md^Xm, Md^Xm, Md^Xm, Md^Xm, Md^Xm, Md^Xm, Md^Xm, Md^Xm, Md^Xm, Md^Xm, Md^Xm, Md^Xm, Md^Xm, Md^Xm, Md^Xm, Md^Xm, Md^Xm, Md^Xm, Md^Xm, Md^Xm, Md^Xm, Md^Xm, Md^Xm, Md^Xm, Md^Xm, Md^Xm, Md^Xm, Md^Xm, Md^Xm, Md^Xm, Md^Xm, Md^Xm, Md^Xm, Md^Xm, Md, Md, Md, Md, Hhd, Gd, Rd, Rd, Hhd, Md, Md, Md, Md, Md^Xm, Md^Xm
