Qxua, Qxua, Qxua, Qxua, Qxua, Qxua, Qxua, Qxua, Qxua, Qxua, Qxua, Qxua, Qxua, Qxua, Xos, Xos, Xos, Xos, Xos, Xos, Xu, Gg^Ii, Gg^Ii, Gg^Ii, Xu, Xu, Qxua, Qxua, Qxua, Qxua, Qxua, Qxua, Qxua, Qxua, Qxua
Qxua, Qxua, Qxua, Qxua, Qxua, Qxua, Qxua, Qxua, Qxua, Qxua, Qxua, Qxua, Qxua, Qxua, Xos, Xos, Irs^Ii, Irs^Ii, Irs^Ii, Xos, Xu, Gg^Ii, Gg^Ii, Gg^Ii, Xu, Qxua, Qxua, Qxua, Qxua, Qxua, Qxua, Qxua, Qxua, Qxua, Qxua
Qxua, Qxua, Qxua, Qxua, Qxua, Qxua, Qxua, Qxua, Qxua, Qxua, Qxua, Qxua, Xos, Xos, Xos, Xos, Xos^Efs, Irs^Ii, Xos^Efs, Xu, Urb, Gg^Ii, Urb, Xos, Qxua, Qxua, Qxua, Qxua, Qxua, Qxua, Qxua, Qxua, Qxua, Qxua, Qxua
Qxua, Qxua, Qxua, Qxua, Qxua, Qxua, Qxua, Qxua, Qxua, Qxua, Xos, Xos, Gll^Ftr, Gll^Ftr, Gll^Ftr, Cud, Urb, 4 Kud, Urb, Cud, Urb, Urb, Uh, Xos, Qxua, Qxua, Qxua, Qxua, Qxua, Qxua, Qxua, Qxua, Qxua, Qxua, Qxua
Qxua, Qxua, Qxua, Qxua, Qxua, Qxua, Qxua, Qxua, Qxua, Xos, Gll^Ftr, Uh, Gll^Ftr, Gll^Ftr, Cud, Cud, Cud, Cud, Cud, Cud, Cud, Urb, Uh, Xos, Xos, Qxua, Qxua, Qxua, Qxua, Qxua, Qxua, Qxua, Qxua, Qxua, Qxua
Qxua, Qxua, Qxua, Qxua, Qxua, Qxua, Qxua, Qxua, Xos, Xos, Gll^Ftr, Uh, Uh^Vud, Gll^Ftr, Urb, Uu^Vud, Wwf, Wwf, Wwf, Uu^Vud, Urb, Urb, Gll^Ftr, Uh^Vud, Gll^Ftr, Xos, Xos, Qxua, Qxua, Qxua, Qxua, Qxua, Qxua, Qxua, Qxua
Qxua, Qxua, Qxua, Qxua, Qxua, Qxua, Qxua, Xos, Xos, Gll^Ftr, Gll^Ftr, Gll^Ftr, Gll^Ftr, Gll^Ftr, Urb, Wwf, Ww, Ww, Ww, Wwf, Urb, Urb, Urb, Gll^Ftr, Gll^Ftr, Gll^Ftr, Xos, Qxua, Qxua, Qxua, Qxua, Qxua, Qxua, Qxua, Qxua
Qxua, Qxua, Qxua, Qxua, Qxua, Qxua, Qxua, Qxua, Qxua, Xos, Xos, Gll^Ftr, Uh, Uh, Urb, Wwf, Ww, Wo, Ww, Wwf, Urb, Urb, Uh, Gll^Ftr, Gll^Ftr, Gll^Ftr, Xos, Qxua, Qxua, Qxua, Qxua, Qxua, Qxua, Qxua, Qxua
Qxua, Qxua, Qxua, Qxua, Qxua, Qxua, Qxua, Qxua, Qxua, Qxua, Xos, Uh, Uh, Uh, Urb, Wwf, Wwf, Ww, Wwf, Wwf, Urb, Uh, Gll^Ftr, Gll^Ftr, Xos, Xos, Qxua, Qxua, Qxua, Qxua, Qxua, Qxua, Qxua, Qxua, Qxua
Qxua, Qxua, Qxua, Qxua, Qxua, Qxua, Qxua, Qxua, Qxua, Qxua, Qxua, Xos, Xos, Uh, Gll^Ftr, Urb, Wwf, Ww, Ww, Urb, Urb, Uh, Gll^Ftr, Gll^Ftr, Xos, Qxua, Qxua, Qxua, Qxua, Qxua, Qxua, Qxua, Qxua, Qxua, Qxua
Qxua, Qxua, Qxua, Qxua, Qxua, Qxua, Qxua, Qxua, Qxua, Qxua, Qxua, Uu, Uh, Xos, Xos, Urb, Urb, Ww, Ww, Ww, Ww, Gll^Ftr, Xos^Efs, Xos, Uu, Qxua, Uu, Qxua, Qxua, Qxua, Qxua, Qxua, Qxua, Qxua, Qxua
Qxua, Qxua, Qxua, Qxua, Qxua, Qxua, Qxua, Qxua, Qxua, Qxua, Qxua, Uu, Uh, Uh, Xos, Urb, Urb, Urb, Xos^Efs, Xos, Ww, Ww, Ww, Uu, Uu^Uf, Uu, Xu, Uu, Uu, Qxua, Qxua, Qxua, Qxua, Qxua, Qxua
Qxua, Qxua, Qxua, Qxua, Qxua, Qxua, Qxua, Qxua, Qxua, Qxua, Qxua, Uu, Uh, Xos, Xos, Urb, Qxua^Bcx|, Urb, Urb, Qxua, Qxua, Ww, Ww, Uu, Uu, Xu, Uu^Vud, Uu, Uu, Qxua, Qxua, Qxua, Qxua, Qxua, Qxua
Qxua, Qxua, Qxua, Qxua, Qxua, Qxua, Qxua, Qxua, Qxua, Qxua, Qxua, Qxua, Uu, Uh, Xos^Efs, Urb, Urb, Qxua, Qxua, Urb, Uu, Uu^Vud, Ww, Xu, Xu, Xu, Uu, Uu, Uu, Qxua, Qxua, Qxua, Qxua, Qxua, Qxua
Qxua, Qxua, Qxua, Qxua, Qxua, Qxua, Qxua, Qxua, Qxua, Qxua, Qxua, Qxua, Qxua, Qxua, Qxua, Urb, Urb, Qxua, Uu, Uu, Uu, Ww, Xu, Xu, Gll^Ftr, Uu, Ur, Uu, Uu, Qxua, Qxua, Qxua, Qxua, Qxua, Qxua
Qxua, Qxua, Qxua, Qxua, Qxua, Qxua, Qxua, Qxua, Qxua, Qxua, Qxua, Qxua, Qxua, Qxua, Urb, Urb, Urb, Urb, Uu, Uu, Uu, Ww, Xu, Gll^Ftr, Gll^Ftr, Ur, Ur, Uu, Uu, Qxua, Qxua, Qxua, Qxua, Qxua, Qxua
Qxua, Qxua, Qxua, Qxua, Co, Co, Co, Qxua, Qxua, Qxua, Qxua, Qxua, Qxua, Qxua, Qxua, Urb, Urb, Urb, Uu, Uu, Ww, Ww, Xu, Gll^Ftr, Ur, Ur, Uu, Uu, Qxua, Qxua, Qxua, Qxua, Qxua, Qxua, Qxua
Qxua, Qxua, Qxua, Qxua, Co, 5 Ko, Uu, Uu, Uu^Ftr, Uu^Ftr, Uu^Ftr, Qxua, Qxua, Qxua, Urb, Urb, Uu, Uu, Ww, Ww, Xu, Xu, Uh^Ftr, Gll^Ftr, Ur, Ur, Uu^Vud, Xu, Xu, Qxua, Qxua, Qxua, Qxua, Qxua, Qxua
Qxua, Qxua, Qxua, Qxua, Uu, Ur, Ur, Ur^Ftr, Ur^Ftr, Ur^Ftr, Ur^Ftr, Uu, Uu, Qxua, Urb, Qxua^Bcx|, Uu, Ww, Uu^Uf, Xu, Xu, Xu, Uh^Ftr, Uh^Ftr, Uu, Ur, Co, Co, Co, Xu, Qxua, Qxua, Qxua, Qxua, Qxua
Qxua, Qxua, Qxua, Qxua, Ur, Ur, Xu, Uu^Vu, Xu, Uu, Ur, Uu^Ftr, Uu, Urb, Urb, Urb, Uu, Ww, Ww, Xu, Uh, Uh, Uh, Uu, Uu, Ur, Ur, 3 Ko, Co, Xu, Qxua, Qxua, Qxua, Qxua, Qxua
Qxua, Qxua, Qxua, Qxua, Uu, Ur, Ur, Xu, Xu, Uu, Uu, Ur, Ur, Urb, Urb, Urb, Qxua, Uu, Ww, Wwf, Wwf, Uh, Qxua, Uu, Uu, Uu, Ur, Co, Uu, Xu, Qxua, Qxua, Qxua, Qxua, Qxua
Qxua, Qxua, Qxua, Qxua, Qxua, Uu, Ur, Uh, Uh, Xu, Xu, Uu, Uu, Urb, Urb, Qxua, Qxua, Ss, Ww^Vm, Ss, Ss, Qxua, Uu, Uu, Ur, Ur, Uu, Uu, Qxua, Qxua, Qxua, Qxua, Qxua, Qxua, Qxua
Qxua, Qxua, Qxua, Qxua, Qxua, Uu, Ur, Uh, Uh, Xu, Xu, Uu, Uu, Qxua^Bcx|, Urb, Urb, Qxua, Ss, Urb, Ss, Ss, Qxua, Uu, Uu, Uu, Ur, Uu, Uu, Qxua, Qxua, Qxua, Qxua, Qxua, Qxua, Qxua
Qxua, Qxua, Qxua, Qxua, Uh, Uu, Ur, Uh, Ur, Uu^Uf, Ur, Xu, Qxua, Urb, Urb, Urb, Urb, Urb, Qxua, Qxua, Ww, Ss, Ss, Uu, Uu, Uu, Uu, Uu, Qxua, Qxua, Qxua, Qxua, Qxua, Qxua, Qxua
Qxua, Qxua, Qxua, Qxua, Uh, Uh, Ur, Ur, Ur, Ur, Uu, Uu, Qxua, Urb, Urb, Urb, Gll^Ftr, Gll^Ftr, Wwf, Chs, Ww, Ss, Gll^Ftr, Wwf, Uu, Uu, Qxua, Qxua, Qxua, Qxua, Qxua, Qxua, Qxua, Qxua, Qxua
Gll^Ftr, Gll^Ftr, Gll^Ftr, Gll^Ftr, Uh, Uh, Ur, Uu, Uu, Ur, Ur, Uu, Qxua, Qxua, Urb, Urb, Gll^Ftr, Gll^Ftr, Wwf, Ss, Gll^Ftr, Gll^Ftr, Ur, Ur, Uu, Uu, Uu, Qxua, Qxua, Qxua, Qxua, Qxua, Qxua, Qxua, Qxua
Gll^Ftr, Gll^Ftr, Gll^Ftr, Ur, Ur, Ur, Xu, Xu, Xu, Ur, Ur, Qxua, Qxua, Qxua, Urb, Gll^Ftr, Gll^Ftr, Uh, Gll^Ftr, Gll^Ftr, Ur, Gll^Ftr, Uu, Uu, Uu^Vud, Gll^Ftr, Gll^Ftr, Gll^Ftr, Gll^Ftr, Qxua, Qxua, Qxua, Qxua, Qxua, Qxua
Qxua, Gll^Ftr, Qxua, Qxua, Qxua, Uu, Xu, Uu^Uf, Uu, Ur, Uu, Qxua, Qxua, Qxua, Qxua, Urb, Urb, Gll^Ftr, Ur, Ur, Uu, Uu, Xu, Xu, Xu, Gll^Ftr, Gll^Ftr, Gll^Ftr, Qxua, Qxua, Qxua, Qxua, Qxua, Qxua, Qxua
Qxua, Qxua, Qxua, Qxua, Uu, Uu, Xu, Xu, Uu, Ur, Ur, Uu, Qxua, Qxua, Qxua, Urb, Urb, Ur, Ur, Uu, Uu, Xu, Xu, Xu, Xu, Xu, Xu, Xu, Qxua, Qxua, Qxua, Qxua, Qxua, Qxua, Qxua
Qxua, Qxua, Qxua, Uu, Uu, Uu^Vu, Xu, Uu, Ur, Uu, Ur, Uu, Qxua, Qxua, Qxua, Urb, Urb, Urb, Ur, Uu, Uu, Xu, Xu, Xu, Xu, Xu, Qxua, Qxua, Qxua, Qxua, Qxua, Qxua, Qxua, Qxua, Qxua
Qxua, Qxua, Qxua, Uu, Xu, Xu, Ur, Ur, Ur, Ur, Uu, Ur, Ur, Qxua, Urb, Urb, Urb, Urb, Uu, Ur, Ur, Xu, Uu, Uu^Vud, Uu, Qxua, Qxua, Qxua, Qxua, Qxua, Qxua, Qxua, Qxua, Qxua, Qxua
Qxua, Qxua, Qxua, Xu, Xu, Xu, Ur, Uu, Xu, Uu, Uu, Uu, Ur, Uu, Qxua, Urb, Urb, Qxua^Bcx|, Uu, Ur, Uu, Uu, Ur, Uu, Uu, Uu, Uu, Qxua, Qxua, Qxua, Qxua, Qxua, Qxua, Qxua, Qxua
Qxua, Qxua, Qxua, Xu, Uu, Xu, Ur, Ur, Xu, Uu^Uf, Uu, Uu, Gll^Ftr, Uu, Qxua, Urb, Urb, Urb, Uu, Uu, Ur, Ur, Xu, Xu, Ur, Uu, Uu, Qxua, Qxua, Qxua, Qxua, Qxua, Qxua, Qxua, Qxua
Qxua, Qxua, Qxua, Uu, Ur, Ur, Ur, Uu, Xu, Xu, Uu, Gll^Ftr, Gll^Ftr, Uh, Gll^Ftr, Gll^Ftr, Urb, Urb, Uu, Uu, Ur, Xu, Xu, Xu, Uu^Vud, Ur, Uu, Qxua, Qxua, Qxua, Qxua, Qxua, Qxua, Qxua, Qxua
Qxua, Qxua, Qxua, Uu, Ur, Ur, Uu, Xu, Xu, Xu, Uu, Gll^Ftr, Gll^Ftr, Gll^Ftr, Gll^Ftr, Gll^Ftr, Urb, Urb, Uu^Uf, Uu^Uf, Uh, Ur, Ur, Ur, Ur, Ur, Uu, Qxua, Qxua, Qxua, Qxua, Qxua, Qxua, Qxua, Qxua
Qxua, Qxua, Qxua, Uu, Uu, Ur, Uu, Xu, Xu, Xu, Uu^Vu, Ur, Uh, Gll^Ftr, Qxua, Urb, Urb, Urb, Urb, Uu^Uf, Uh, Uh, Uh, Ur, Ur, Ur, Uu, Qxua, Qxua, Qxua, Qxua, Qxua, Qxua, Qxua, Qxua
Qxua, Qxua, Qxua, Qxua, Uu, Ur, Ss, Ss, Ss, Xu, Uu, Uu, Uh, Uh, Urb, Urb, Urb, Urb, Urb, Qxua, Qxua, Uh, Qxua, Uu, Uu, Uu, Qxua, Qxua, Qxua, Qxua, Qxua, Qxua, Qxua, Qxua, Qxua
Qxua, Qxua, Qxua, Qxua, Qxua, Uu, Ss, Ss, Ss, Ss, Ur, Ur, Ur, Uh, Urb, Urb, Urb, Urb, Urb, Urb, Qxua, Qxua, Qxua, Qxua, Qxua, Qxua, Qxua, Qxua, Qxua, Qxua, Qxua, Qxua, Qxua, Qxua, Qxua
Qxua, Qxua, Qxua, Qxua, Qxua, Qxua, Qxua, Ss, Ss, Ss, Ur, Uu, Uh, Uh, Urb, Urb, Uu, Uu^Uf, Uu, Urb, Urb, Urb, Urb, Qxua, Qxua, Qxua, Qxua, Qxua, Qxua, Qxua, Qxua, Qxua, Qxua, Qxua, Qxua
Qxua, Qxua, Qxua, Qxua, Qxua, Qxua, Uu, Ss, Ss, Ur, Xu, Xu, Qxua, Qxua, Xu, Urb, Urb, Uh, Uu, Uu, Xu, Urb, Urb, Qxua, Qxua, Qxua, Qxua, Qxua, Qxua, Qxua, Qxua, Qxua, Qxua, Qxua, Qxua
Qxua, Qxua, Qxua, Qxua, Uu, Chr, Chr, Uu, Uu^Uf, Ur, Uu^Uf, Qxua, Qxua, Qxua, Xu, Urb, Uu, Uu, Uh, Uu^Vu, Uh, Xu, Xu, Urb, Qxua, Qxua, Qxua, Qxua, Qxua, Qxua, Qxua, Qxua, Qxua, Qxua, Qxua
Xu, Qxua, Qxua, Uu^Vu, Uh, 2 Khr, Chr, Chr, Ur, Ur, Xu, Qxua, Qxua, Xu, Urb, Urb, Urb, Uu, Uu, Uh, Uh, Xu, Xu, Urb, Qxua, Qxua, Qxua, Qxua, Qxua, Qxua, Qxua, Qxua, Xu, Qxua, Qxua
Xu, Xu, Xu, Uh, Uu^Uf, Chr, Uu^Uf, Ur, Ur, Uu^Uf, Xu, Qxua, Qxua, Urb, Urb, Urb, Urb, Urb, Uu, Uh, Uu^Vud, Uh, Xu, Urb, Urb, Qxua, Qxua, Qxua, Qxua, Qxua, Xu, Xu, Xu, Xu, Xu
Xu, Xu, Xu, Uh, Uh, Ur, Ur, Ur, Ur, Ur, Xu, Qxua, Qxua, Xu, Xu, Urb, Urb, Urb, Ce, Uu, Uu, Uh, Uu, Urb, Urb, Urb, Urb, Qxua, Xu, Xu, Xu, Xu, Xu, Xu, Xu
Xu, Xu, Xu, Xu, Xu, Uh, Xu, Ur, Uu^Uf, Xu, Qxua, Qxua, Qxua, Qxua, Qxua, Urb, Urb, Ce, 1 Ke, Ce, Ce, Uu, Urb, Urb, Urb, Urb, Urb, Urb, Xu, Xu, Xu, Xu, Xu, Xu, Xu
Xu, Xu, Xu, Xu, Xu, Xu, Xu, Xu, Xu, Xu, Xu, Xu, Xu, Xu, Xu, Urb, Urb, Ce, Xu, Xu, Xu, Xu, Xu, Xu, Xu, Urb, Xu, Xu, Xu, Xu, Xu, Xu, Xu, Xu, Xu
Xu, Xu, Xu, Xu, Xu, Xu, Xu, Xu, Xu, Xu, Xu, Xu, Xu, Xu, Xu, Xu, Urb, Xu, Xu, Xu, Xu, Xu, Xu, Xu, Xu, Xu, Xu, Xu, Xu, Xu, Xu, Xu, Xu, Xu, Qxua
Xu, Xu, Xu, Xu, Xu, Xu, Xu, Xu, Xu, Xu, Xu, Xu, Xu, Xu, Xu, Xu, Urb, Xu, Xu, Xu, Xu, Xu, Xu, Xu, Xu, Xu, Xu, Xu, Xu, Xu, Xu, Xu, Xu, Xu, Qxua
