Xoc, Xoc, Xoc, Xoc, Xoc, Xoc, Xoc, Irs, Xoc, Xoc, Xoc, Xoc, Xoc, Xoc, Xoc, Xoc, Irs, Xoc, Xoc, Xoc
Xoc, Xoc, Xoc, Xoc, Xoc, Xoc, Xoc, Irs, Xoc, Xoc, Xoc, Xoc, Xoc, Xoc, Xoc, Xoc, Irs, Xoc, Xoc, Xoc
Xoc, Xoc, Xoc, Xoc, Xoc, Xoc, Xoc, Irs, Xoc, Xoc, Xoc, Xoc, Xoc, Xoc, Cud, Xoc, Irs, Xoc, Xoc, Xoc
Xoc^Efs, Xoc, Xoc^Efs, Xoc, Xoc^Efs, Cud, Xoc^Efs, Irs, Xoc^Efs, Cud, Xoc^Efs, Xoc, Xoc^Efs, Xoc, Irs, Irs, Irs, Irs^Ebn, Ch, Xoc
Irs, Irs, Irs, Irs, Irs, Irs, Irs, Irs, Irs, Irs, Irs, Irs, Irs, Irs, Irs, Irs, Irs, Irs, Ch, Xoc
Irs, 1 Irs, Irs, Irs, Irs, Irs, Irs, Irs, Irs, Irs, Irs, Irs, Irs, Irs, Irs, Irs, Irs, Irs, Kh, Xoc
Irs, Irs, Irs, Irs, Irs, Irs, Irs, Irs, Irs, Irs, Irs, Irs, Irs, Irs, Irs, Irs, Irs, Irs, Ch, Xoc
Xoc, Xoc, Xoc, Xoc, Cud, Xoc, Xoc, Irs, Xoc, Xoc, Cud, Xoc, Xoc, Irs, Irs, Irs, Irs, Irs, Ch, Xoc
Xoc, Xoc, Xoc, Xoc, Xoc, Xoc, Xoc, Irs, Xoc, Xoc, Xoc, Xoc, Xoc, Xoc, Cud, Irs, Irs, Irs^Ebn, Xoc, Xoc
Xoc, Xoc, Xoc, Xoc, Xoc, Xoc, Xoc, Irs, Xoc, Xoc, Xoc, Xoc, Xoc, Xoc, Xoc, Xoc, Irs, Xoc, Xoc, Xoc
Xoc, Xoc, Xoc, Xoc, Xoc, Xoc, Xoc, Irs, Xoc, Xoc, Xoc, Xoc, Xoc, Xoc, Xoc, Xoc, Irs, Xoc, Xoc, Xoc
Xoc, Xoc, Xoc, Xoc, Xoc, Xoc, Xoc, Irs, Xoc, Xoc, Xoc, Xoc, Xoc, Xoc, Xoc, Xoc, Irs, Xoc, Xoc, Xoc
