Uu, Xu, Xu, Xos, Xos, Xos, Xos, Xos, Xos, Xos, Xos, Xos, Xos, Xos, Xos, Xos, Xos, Xos, Xos, Xos, Xos, Xos, Xos, Xos, Xos, Xos, Xos, Xos, Xos, Ww, Ww, Wo, Wo, Wo, Wo, Ww, Ww, Xos, Xos, Xos, Xos, Xos, Xos, Xos, Xos, Xos, Xos, Xos, Xos, Xos, Gll^Ii, Xos, Xos, Xos, Xos, Xos, Xos, Xos, Xos, Xos, Xos, Xos
Xu, Uu, Uu, Xu, Xos, Xos, Xos, Xos, Xos, Xos, Xos, Xos, Xos, Xos, Xos, Xos, Xos, Xos, Xos, Xos, Xos, Xos, Xos, Xos, Xos, Xos, Xos, Xos, Xos, Ww, Ww, Wo, Wo, Wo, Ww, Wo, Ww, Xos, Xos, Xos, Xos, Xos, Xos, Xos, Xos, Xos, Xos, Xos, Xos, Xos, Gll^Ii, Xos, Xos, Qxua, Qxua, Qxua, Qxua, Xos, Xos^Efs, Xos, Xos^Efs, Xos
Xos, Xu, Uu, Xu, Xu, Xos, Cud, Xos^Efs, Urb, Xos^Efs, Urb, Xos^Efs, Urb, Xos^Efs, Uu^Vud, Xos, Xos, Xos, Xos, Xos, Xos, Xos, Xos, Xos, Xos, Xos, Xos, Xos, Xos, Ww, Ww, Wo, Wo, Ww, Ww, Ww, Xos, Xos, Xos, Xos, Xos, Xos, Xos, Xos, Xos, Xos, Xos, Xos, Xos, Xos, Urb^Ii, Xos^Efs, Urb, Urb, Urb, Qxua, Urb, Qxua, Urb, Urb, Urb, Urb
Xos, Xu, Xu, Uu, Urb, Cud, 1 Kud, Urb, Urb, Urb, Urb, Urb, Urb, Urb, Urb, Urb, Urb, Xos^Efs, Urb, Xos^Efs, Urb, Xos^Efs, Urb, Xos, Xos^Efs, Xos, Xos^Efs, Xos, Xos^Efs, Xos, Xos^Efs, Ww, Ww, Wo, Wo^Pr/, Ww^Pr/, Xos, Xos, Xos, Xos, Xos, Xos, Xos, Xos, Xos, Xos, Xos, Xos, Xos, Xos, Xos, Urb, Urb, Urb, Qxua, Urb, Qxua, Urb, Qxua, Xos, Xos, Xos
Xos, Xos, Xos, Xu, Urb, Urb, Urb, Urb, Urb, Urb, Urb, Urb, Urb, Urb, Urb, Urb, Urb, Urb, Urb, Urb, Urb, Urb, Urb, Urb, Urb, Urb, Urb, Xos, Xos, Xos, Ds, Ww^Pr\, Xos, Wo^Pr/, Wo, Ww, Ww, Xos, Xos, Xos, Xos, Xos, Xos, Xos, Xos, Xos, Xos, Xos, Xos, Xos, Xos, Xos, Urb^Pr|, Xos, Xos, Qxua, Xos, Qxua, Xos, Xos, Xos, Xos
Xos, Xos, Xos, Xos, Urb^Ebn, Urb, Kud, Urb, Urb, Urb, Urb, Urb, Urb, Urb, Urb, Urb, Urb, Urb, Urb, Urb, Urb, Urb, Urb, Urb, Xos, Urb, Xos, Urb^Pr/, Urb, Urb, Ds, Ww, Ww, Wo, Wo, Wo, Wo, Xos, Xos, Xos, Xos, Xos, Xos, Xos, Xos, Xos, Xos, Xos, Xos, Xos, Xos, Xos, Rp, Xos, Xos, Xos, Xos, Xos, Xos, Xos, Xos, Xos
Xos, Xos, Xos, Xos, Xos, Cud, Cud, Urb, Urb, Urb, Urb, Urb, Urb, Urb, Uu^Vud, Urb, Xos, Xos, Xos, Xos, Xos, Xos, Xos, Xos, Xu, Xos, Xu, Urb^Ebn, Urb, Urb, Ds, Ww, Wo, Wo, Wo, Wo, Wo, Wo, Wo, Xos, Xos, Xos, Xos, Xos, Xos, Xos, Xos, Xos, Gd^Fetd, Xos, Rp^Ii, Rp, Gg^Ve, Gll^Fdw, Xos, Xos, Xos, Xos, Xos, Xos, Xos, Xos
Xos, Xos, Xos, Xos, Xos, Xos, Xos, Xos, Xos, Xos, Xos, Xos, Xos, Xos, Xos, Xos, Xu, Xos, Xu, Xos, Xu, Xu, Xu, Xu, Xu, Xu, Urb, Urb, Urb, Ds, Ww, Ww, Wo, Xos, Wo, Wo, Wo, Xos, Wo, Wo, Wo, Xos, Xos, Xos, Xos, Xos, Xos, Xos, Xos, Gll^Ii, Rp, Ww, Gll^Ii, Gll^Fdw, Gll^Fdw, Xos, Xos, Xos, Xos, Xos, Xos, Xos
Xos, Xos, Xos, Xos, Xos, Xos, Xos, Xos, Xos, Xos, Xu, Xu, Xu, Xu, Xu, Xu, Xu, Xu, Xu, Xu, Xu, Xu, Xu, Xu, Xu, Xu, Urb, Urb, Urb, Ds, Wo, Wo, Wo, Wo, Ww, Ww, Xos, Wo, Wo, Wo, Wo, Wo, Wo^Pr/, Xos, Xos, Xos, Xos, Xos, Gll^Fdw, Gll^Fdw, Rp, Ww, Ww, Gll^Fdw, Gll^Fdw, Xos, Xos, Xos, Xos, Xos, Xos, Xos
Xos, Xos, Xos, Xos, Xos, Xos, Xos, Xos, Xos, Xos, Xu, Xu, Uu, Uu, Ior, Ior, Ior, Xu, Uu, Uu^Vu, Uu, Uu, Uu, Uu, Uu, Xu, Urb, Urb, Ds, Ds, Ww, Wo, Wo, Ww, Ww, Ww, Xos, Xos, Xos, Wo, Xos, Wo^Pr/, Wo, Wo, Ww, Ww, Xos^Efs, Xos, Xos, Gll^Fdw, Rp, Gll^Ii, Ww, Ww, Gll^Fdw, Xos, Xos, Xos, Xos, Xos, Xos, Xos
Xos, Xos, Xos, Xos, Xos, Xos, Xos, Xos, Xos, Xu, Xu, Uu^Vu, Urb, Uu, Ior, Ior, Ior, Uu, Uu, Uu, Urb, Uu, Urb, Uu, Uu, Uu, Urb, Urb, Ww, Ww, Wo, Xos, Wo, Wo, Ww, Ww, Xos, Xos, Xos, Xos, Xos, Xos, Xos, Ww, Xos, Ww, Ds, Ds, Ds, Rp^Pr\, Xos, Xos, Xos, Gll^Fdw, Xos, Xos, Xos, Xos, Xos, Xos, Xos, Xos
Xos, Xos, Xos, Xos, Xos, Xos, Xos, Xos, Xos, Xu, Xu, Uu, Urb, Urb, Urb, Uu, Ior, Ior, Urb, Urb, Uu, Urb, Uu, Urb, Uu, Uu, Urb, Ww, Ww, Wo, Wo, Wo, Wo, Wo, Ww, Xos, Xos, Xos, Xos, Xos, Xos, Xos, Xos, Xos, Xos, Ss, Wwf, Ss, Wwf, Ww^Vm, Xos, Xos, Wo, Xos, Xos, Xos, Xos, Xos, Xos, Xos, Xos, Xos
Xos, Xos, Xos, Xos, Xos, Xos, Xos, Xos, Xu, Xu, Xu, Chr, Ior, Urb, Uu, Urb, Urb, Urb, Uu, Urb, Urb, Urb, Urb, Urb, Urb, Urb, Urb, Ww, Ww, Wo, Wo, Wo, Ww, Ww, Xos, Xos, Xos, Xos, Xos, Xos, Xos, Xos, Qlf, Xos, Qlf, Xos, Wwf^Pr\, Wwf, Wwf^Pr/, Ww^Pr/, Wo, Wo, Wo, Wo, Wo, Xos, Xos, Xos, Wo, Xos, Xos, Xos
Xos, Xos, Xos, Xos, Xos, Xos, Xos, Xos, Ior, Chr, Chr, 2 Khr, Urb, Ior, Ior, Uu, Urb, Uu^Vu, Uu, Urb, Urb, Urb, Urb, Urb, Urb, Urb, Ds, Ww, Wo, Xos, Wo, Wo, Ww, Xos, Xos, Xos, Xos, Xos, Xos, Xos, Qlf, Qlf, Qlf, Qlf, Qlf^Bcx/, Qlf^Bcx/, Xos, Xos, Xos, Wo, Xos, Wo, Wo, Wo, Wo, Wo, Wo, Wo, Wo, Xos, Xos, Xos
Xos, Xos, Xos, Xos, Xos, Xos, Xos, Xos, Ior, Ior, Ior, Chr, Urb, Urb, Urb, Urb, Urb, Urb, Urb, Urb, Urb, Urb, Urb, Urb, Urb, Urb, Ds, Ww, Ww, Wo, Ww, Ww, Kud, Xos, Xos, Xos, Xu, Xos, Xu, Xos, Qlf, Qlf, Uu, Uu, Uu, Qlf, Qlf, Xos, Xos, Xos, Xos, Xos, Xos, Wo, Wo, Wo, Wo, Wo, Wo, Wo, Xos, Xos
Xos, Xos, Xos, Xos, Xos, Xos, Xos, Xos, Xos, Ior, Ior, Ior, Xu, Xu, Xu, Urb, Xu, Urb, Xu, Urb, Xu, Urb, Urb, Urb, Urb, Urb, Ds, Ww, Ww, Ww, Wwf, Wwf, Cud, Cud, Cud, Xu, Uu^Vu, Xu, Qxua, Xu, Rr^Pr\, Qlf^Bcx/, Qlf, Uu^Vud, Qlf, Qlf, Xos, Xos, Xos, Xos, Xos, Xos, Xos, Xos, Wo, Wo, Wo, Wo, Wo, Wo, Wo, Xos
Xos, Xos, Xos, Xos, Xos, Xos, Xos, Xos, Xos, Xu, Xos, Xu, Xos, Xu, Xos, Xu, Xu, Xu, Xos, Xu, Xos, Xu, Xos, Urb, Urb, Urb, Ww^Bw\r, Ww, Ss, Ww, Wwf, Wwf, Urb, Cud, Xu, Xu, Uu^Em, Uu^Em, Uu^Em, Uu^Em, Xu, Xos, Xos, Qlf, Xos, Xos, Xos, Xos, Xos, Xos, Xos, Xos, Xos, Xos, Xos, Wo, Wo, Wo, Wo, Wo, Wo, Wo
Xos, Xos, Xos, Xos, Xos, Xos, Xos, Xos, Xos, Xos, Xos, Xos, Xos, Xos, Xos, Xos, Xos, Xos, Xos, Xos, Xos, Xos, Xos, Xos, Xos, Ww^Bw\r, Wwf^Bw\r, Wwf^Bw\r, Wwf^Bw\r, Ss, Ss^Bw/r, Wwf^Bw/r, Urb, Urb, Urb, Rr^Pr\, Xu, Uu^Em, Uu^Em, Xu, Xu, Xos, Xos, Xos, Xos, Xos, Xos, Xos, Xos, Xos, Xos, Xos, Xos, Xos, Xos, Wo, Xos, Wo, Xos, Wo, Wo, Wo
Xos, Xos, Xos, Xos, Xos, Xos, Xos, Xos, Xos, Xos, Xos, Xos, Xos, Xos, Xos, Xos, Xos, Xos, Xos, Xos, Xos, Xos, Xos, Xos, Xos, Xos, Ww, Wwf^Bw\r, Ss^Bw\r, Wwf^Bw/r, Ss^Bw/r, Ss^Bw/r, Ss, Urb, Xos, Xu, Xu, Qxua, Xu, Uu^Em, Xu, Xos, Xos, Xos, Xos, Xos, Xos, Xos, Xos, Xos, Xos, Xos, Xos, Xos, Xos, Xos, Xos, Xos, Xos, Xos, Xos, Wo
Xos, Xos, Xos, Xos, Xos, Xos, Xos, Xos, Xos, Xos, Xos, Xos, Xos, Xos, Xos, Xos, Xos, Xos, Xos, Xos, Xos, Xos, Xos, Xos, Xos, Xos, Xos, Ss, Ss, Wwf^Bw\r, Wwf, Wwf, Ss, Xos, Xos, Xos, Xos, Xos, Xos, Xu, Xos, Xos, Xos, Xos, Xos, Xos, Xos, Xos, Xos, Xos, Xos, Xos, Xos, Xos, Xos, Xos, Xos, Xos, Xos, Xos, Xos, Xos
Xos, Xos, Xos, Xos, Xos, Xos, Xos, Xos, Xos, Xos, Xos, Xos, Xos, Xos, Xos, Xos, Xos, Xos, Xos, Xos, Xos, Xos, Xos, Xos, Xos, Xos, Ss, Ss, Wwf, Wwf, Wwf, Ss, Ss, Ss, Xos, Xos, Xos, Xos, Xos, Xos, Xos, Xos, Xos, Xos, Xos, Xos, Xos, Xos, Xos, Xos, Xos, Xos, Xos, Xos, Xos, Xos, Xos, Xos, Xos, Xos, Xos, Xos
Xos, Xos, Xos, Xos, Xos, Xos, Xos, Xos, Xos, Xos, Xos, Xos, Xos, Xos, Xos, Xos, Xos, Xos, Xos, Xos, Xos, Xos, Xos, Xos, Xos, Xos, Ww, Ss, Wo, Ss, Wo, Ss, Ww, Ss, Xos, Xos, Xos, Xos, Xos, Xos, Xos, Xos, Xos, Xos, Xos, Xos, Xos, Xos, Xos, Xos, Xos, Xos, Xos, Xos, Xos, Xos, Xos, Xos, Xos, Xos, Xos, Xos
