Wog, Wog, Wog, Wog, Wog, Wog, Wog, Wog, Wog, Wog, Wog, Wog, Wog, Wog, Wog, Wog, Wog, Wog, Wwg, Wwg, Wwg, Wwg, Wwg, Wo, Wwg, Wo, Wwg, Wo, Wo, Wo, Wo, Wo, Wo, Wo, Wo, Wo, Wo, Wwg, Wwg, Ds, Ds, Gll^Fmf, Hh^Fmf, Hh^Fmf, Hh^Fmf, Hh^Fmf, Gll, Gll^Fmf, Gll, Gll^Fmf, Gll^Fmf, Gll^Fmf, Gll^Fmf, Gll^Fmf, Hh^Fmf, Hh^Fmf, Mm, Mm, Mm, Mm, Hh^Fmf, Hh^Fmf, Hh^Fmf, Gll^Fmf, Gll^Fmf, Gll^Fmf, Gll, Gll
Wog, Wog, Wog, Wog, Wog, Wog, Wog, Wog, Wog, Wog, Wog, Wog, Wog, Wog, Wog, Wog, Cm, Ww^Vm, Wwg, Wwg, Ds, Wwg, Wwg, Wwg, Wwg, Wwg, Wwg, Wwg, Wwg, Wo, Wo, Wo, Wo, Wo, Wo, Wo, Wo, Wwg, Wwg, Ds, Ds, Gll^Fmf, Gll^Fmf, Hh^Fmf, Gll^Fmf, Gll^Fmf, Gll, Gll, Gll, Gll, Gll^Ve, Gll^Fmf, Gll^Fmf, Hh^Fmf, Gll^Fmf, Gll^Fmf, Gll^Fmf, Hh^Fmf, Hh^Fmf, Hh^Fmf, Hh^Fmf, Hh^Fmf, Hh^Fmf, Gll^Fmf, Gll, Gll^Fetd, Gll^Fmf, Gll
Wog, Wog, Wog, Wog, Wo^Vm, Wog, Wog, Wog, Wog, Wog, Wog, Wog, Wog, Wog, Wog, Cm, 2 Km, Cm, Wwg, Wwg, Ds, Gll, Gll, Wwg, Gll^Fmf, Gll^Fmf, Gll^Fmf, Wwg, Wwg, Wwg, Wwg, Wo, Wo, Wo, Wo, Wo, Wo, Wwg, Wwg, Wwg, Ds, Ds, Ds, Gll^Fmf, Ds, Gll^Fmf, Gll^Fetd, Gll, Gll, Gll, Gll^Fmf, Gll^Fmf, Gll^Fmf, Gll^Fmf, Gll, Gll^Fmf, Gll, Gll^Ve, Gll, Hh^Fmf, Gll, Hh^Fmf, Gll, Gll, Gll, Gll, Gll^Fmf, Gll^Fmf
Wog, Wog, Wog, Wog, Wog, Wog, Wog, Wog, Wog, Wog, Wog, Wog, Wog, Wog, Wog, Cm, Cm, Cm, Wwrg, Wwrg, Wwrg, Ds, Ds, Gll^Fmf, Gd^Vhr, Gll^Fmf, Gll, Gll^Fmf, Ds, Wwg, Wwg, Wo, Wo, Wo, Wo, Wo, Wo, Wwg, Wwg, Wwg, Wwg, Wwg, Wwg, Ds, Ds, Ds, Ds, Ds, Ds, Gll^Fmf, Gll^Fmf, Gll^Fmf, Gll, Gll, Gll, Gll, Gll, Gll, Gll, Gll, Gll, Gll, Gll, Gll, Hh^Fmf, Hh^Fmf, Mm, Mm
Wog, Wog, Wog, Wog, Wog, Wog, Wog, Wog, Wog, Wog, Wog, Wog, Wog, Wog, Wog, Mm, Wog, Wwrg, Wwrg, Wwrg, Wwrg, Wwg, Wwg, Gll, Ds, Ds, Ds, Ds, Wwg, Wwg, Wwg, Wo, Wo, Wo, Wo, Wo, Wo, Wwg, Wwg, Wwg, Wwg, Wwg, Wwg, Wwg, Wwg, Wwg, Wwg, Wwg, Ds, Ds, Ds, Gll^Fmf, Ds, Gll^Fmf, Ds, Ds, Ds, Gll, Gll, Gll, Gll, Gll, Gll, Gll, Hh^Fmf, Hh^Fmf, Hh^Fmf, Mm
Wog, Wog, Wog, Wog, Wog, Wog, Wog, Wog, Wwg, Wwg, Wwg, Wog, Wog, Wog, Wog, Wog, Wwg, Wwg, Ds, Ww^Vm, Wwg, Wwg, Wo, Wwg, Wo, Ww, Wo, Wwg, Wwg, Wwg, Wo, Wo, Wo, Wo, Wo, Wo, Wo, Wwg, Wwg, Wwg, Wwg, Wwg, Wwg, Wwg, Wwrg, Wwrg, Wwg, Wwg, Wwg, Ds, Wwg, Ds, Ds, Ds, Wwg, Wwg, Wwg, Ds, Ds, Ds, Ds, Gll, Gll^Fmf, Hh^Fmf, Hh^Fmf, Gll, Gll, Hh^Fmf
Wog, Wog, Wog, Wog, Wog, Wog, Wwg, Wwg, Wwg, Wwg, Ds, Wwg, Wwg, Wog, Wwg, Wwg, Ds, Ds, Ds, Wwg, Wwg, Wo, Wo, Wo, Wo, Wo, Wo, Wo, Wo, Wo, Wo, Wo, Wo, Wo, Wo, Wo, Wo, Wo, Wo, Wwg, Wwg, Wwg, Wwg, Wwg, Wwg, Wwrg, Wwrg, Wwrg, Wwrg, Wwrg, Cme, Wwg, Wwg, Wwg, Wwg, Wwg, Wwg, Wwg, Wwg, Ww^Vm, Ds, Hh^Fmf, Hh^Fmf, Hh^Fmf, Gll^Fmf, Gll, Gll^Fmf, Hh^Fmf
Wog, Wog, Wog, Wog, Wog, Wwg, Wwg, Wwg, Gll, Ds, Gll, Ds, Ds, Wwg, Wwg, Wwg, Wwg, Ds, Wwrg, Wwg, Wo, Wo, Wo, Wo, Wo, Wo, Wo, Wo, Wo, Wo, Wo, Wo, Wo, Wo, Wo, Wo, Wo, Wo, Wo, Wo, Wo, Wwg, Wo, Wwg, Wwg, Wwg, Wwg, Wwg, Cme, Wwrg, 3 Kme, Cme, Wwg, Wwg, Ds, Wwg, Ds, Wwg, Ds, Wwg, Ds, Gll, Gll, Gll^Fmf, Gll, Gll, Hh^Fmf, Hh^Fmf
Wog, Wog, Wog, Wog, Wwg, Wwg, Wwg, Wwg, Ds, Ds, Gll, Gll, Gll, Ds, Gll, Wwg, Wwg, Wwrg, Wwrg, Wwrg, Wo, Wo, Wo, Wo, Wo, Wo, Wo, Wo, Wo, Wo, Wo, Wo, Wo, Wo, Wo, Wo, Wo, Wo, Wo, Wo, Wo, Wo, Wo, Wo, Wo, Wwg, Wwg, Wwg, Wwg, Cme, Wwg, Wwg, Wwg, Ds, Ds, Ds, Ds, Ds, Gll, Ds, Gll^Fmf, Gll, Hh^Fmf, Gll, Gll, Gll^Fmf, Gll, Hh^Fmf
Wog, Wog, Wog, Wog, Ds, Wwg, Ds, Ds, Ds, Ds, Gll, Gll, Gll, Ds, Ds, Wwg, Wwg, Wwg, Wwg, Wo, Wo, Wo, Wo, Wo, Wo, Wo, Wo, Wo, Wo, Wo, Wo, Wo, Wo, Wo, Wo, Wo, Wo, Wo, Wo, Wo, Wo, Wo, Wo, Wo, Wo, Wo, Wo, Wo, Wo, Wwg, Wwg, Wwg, Ds, Wwg, Ds, Ds, Ds, Ds, Ds, Gll^Fmf, Gll^Fmf, Hh^Fmf, Hh^Fmf, Hh, Hh^Fmf, Gll, Gll^Ve, Hh^Fmf
Wog, Wog, Wog, Wwg, Ds, Ds, Gll, Gll, Chr, Gll, Gll, Gll, Gll, Ds, Ds, Wwg, Wwg, Wwg, Wwg, Wwg, Wo, Wo, Wo, Wo, Wo, Wo, Wo, Wo, Wo, Wo^Vm, Wo, Wo, Wo, Wo, Wo, Wo, Wo, Wo, Wo, Wo, Wo, Wo, Wo, Wo, Wo, Wo, Wo, Wo, Wo, Wwg, Wwg, Wwg, Ds, Ds, Ds, Ds, Wwg, Ds, Ds, Ds, Ds, Hh^Fmf, Gll^Fmf, Hh^Fmf, Hh^Fmf, Hh^Fmf, Gll^Fmf, Hh^Fmf
Wog, Wog, Wog, Wwg, Ds, Gll, Gll, Chr, Gd^Vhr, Chr, Gll, Gll, Gll, Ds, Ds, Wwg, Gll, Wwg, Wwg, Wwg, Wo, Wo, Wo, Wo, Wo, Wo, Wo, Wo, Wo, Wo, Wo, Wo, Wo, Wo, Wo, Wo, Wo, Wo, Wo, Wo, Wo, Wo, Wo, Wo, Wo, Wo, Wo, Wo, Wo, Wo, Wwg, Ds, Ds, Ds, Ds, Wwg, Wwg, Wwg, Wwg, Wwg, Wwg, Ds, Ds, Ds, Gll^Fmf, Hh^Fmf, Hh^Fmf, Hh^Fmf
Wog, Wog, Wog, Wwg, Ds, Gll, Hh, Hh, Gll^Fmf, Gll^Fmf, Gll^Fmf, Gll, Gll, Gll, Gll, Ds, Ds, Gll, Ds, Wwg, Ds, Wo, Wo, Wo, Wo, Wo, Wo, Wo, Wo, Wo, Wo, Wo, Wo, Wo, Wo, Wo, Wo, Wo, Wo, Wo, Wo, Wo, Wo, Wo, Wo, Wo, Wo, Wo, Wwg, Wwg, Ds, Ds, Ds, Ds, Wwg, Wwg, Wwg, Wwg, Wwg, Wwg, Wwg, Ds, Wwg, Ds, Ds, Ds, Ds, Gll^Fmf
Wog, Wog, Wog, Wwg, Ds, Ds, Hh, Hh^Fmf, Hh^Fmf, Hh^Fmf, Hh^Fmf, Gll^Fmf, Gll, Gll, Gll, Gll, Gll, Ds, Ds, Ds, Ds, Wo, Wo, Wo, Wo, Wo, Wo, Wo, Wo, Wo, Wo, Wo, Wo, Wo, Wo, Wo, Wo, Wo, Wwrg, Wo, Wwrg, Wo, Wo, Wo, Wo, Wo, Wwg, Wwg, Wwg, Ds, Ds, Ds, Ww^Vm, Wwg, Wwg, Wwg, Wwg, Wwg, Wwg, Wwg, Wwg, Wwg, Wwg, Wwg, Wwg, Ds, Ds, Gll^Fmf
Wog, Wog, Wog, Wwg, Wwg, Ds, Ds, Hh^Fmf, Hh^Fmf, Gll^Fmf, Gll^Fmf, Gll^Fmf, Gll, Ds, Ds, Ds, Ds, Ds, Ds, Ds, Wwg, Wo, Wo, Wo, Wo, Wo, Wo, Wo, Wo, Wo, Wo, Wo, Wo, Wo, Wo, Wo, Wwrg, Wwrg, Wwrg, Wwrg, Wwg, Wwrg, Wwrg, Wwg, Wwg, Wwg, Wwg, Wwg, Ds, Ds, Ds, Ds, Wwg, Wog, Wog, Wwg, Wog, Wwg, Wwg, Wwg, Wwg, Wwg, Wwg, Wwg, Wwg, Wwg, Wwg, Ds
Wog, Wog, Wog, Wwg, Wwg, Wwg, Ds, Hh^Fmf, Hh^Fmf, Hh^Fmf, Hh^Fmf, Gll^Fmf, Ds, Ds, Ds, Ds, Ds, Ds, Wwg, Wwg, Wwg, Wo, Wo, Wo, Wo, Wo, Wo, Wo, Wo, Wo, Wwg, Wwg, Wwg, Wwg, Wwg, Wwg, Wwrg, Wwrg, Wwg, Wwg, Wwrg, Wwg, Wwg, Wwg, Wwg, Wwg, Ds, Wwg, Ds, Ds, Wwg, Wwg, Wwg, Wog, Wog, Wog, Wog, Wog, Wog, Wwg, Wwg, Wwg, Wwg, Wwg, Wwg, Wwg, Wwg, Wwg
Wog, Wog, Wog, Wog, Wwg, Wwg, Wwg, Ds, Ds, Ds, Ds, Ds, Ds, Ds, Ds, Ds, Wwg, Wwg, Wwrg, Wwg, Wwg, Wo, Ds, Wo, Wo, Wo, Wo, Wo, Wo, Wwg, Wwg, Wwg, Ds, Ds, Ds, Ds, Ds, Wwrg, Wwrg, Wwrg, Wwrg, Wwg, Wwrg, Wwg, Wwg, Ds, Ds, Ds, Ds, Wwg, Wog, Wwg, Wog, Wog, Wog, Wog, Wog, Wog, Wog, Wog, Wwg, Wwg, Wwg, Wwg, Wwg, Wwg, Wwg, Wwg
Wog, Wog, Wog, Wog, Wog, Wwg, Wwg, Wwg, Wwg, Ds, Wwg, Ds, Ds, Ds, Wwrg, Wwrg, Wwrg, Wwrg, Ww, Ds, Ds, Ds, Hd, Ds, Hd, Wo, Wo, Wo, Wo, Wwg, Wwg, Ds, Ds, Ds, Gll^Fmf, Gll^Fmf, Gll^Fmf, Ds, Ds, Ds, Chr, Wwg, Wwg, Wwg, Gll^Fmf, Ds, Ds, Ds, Ds, Wwg, Wog, Wog, Wog, Wog, Wog, Wog, Wog, Wog, Wog, Wog, Wog, Wog, Wog, Wwg, Wwg, Wwg, Wwg, Wwg
Wog, Wog, Wog, Wog, Wog, Wog, Wog, Wwg, Wog, Wwg, Wwg, Wwg, Wwg, Wwg, Wog, Wwrg, Wog, Ww, Wwrg, Ds, Ds, Hd, Hd, Hd, Cer, Ds, Wo, Wo, Wo, Wwg, Wwg, Ds, Gll^Fmf, Gll^Fmf, Gd^Vhr, Gll^Fmf, Ds, Gll, Gll, Gll, Gll, Gll, Gll, Gll^Fmf, Gll, Ds, Ds, Ds, Ds, Wwg, Wwg, Wog, Wog, Wog, Wog, Wog, Wog, Wog, Wog, Wog, Wog, Wog, Wog, Wog, Wog, Wo^Vm, Wog, Wwg
Wog, Wog, Wog, Wog, Wog, Wog, Wog, Wog, Wog, Wog, Wog, Wog, Wog, Wog, Wog, Wog, Wog, Wog, Wwrg, Wwrg, Wwrg, Ds, Cer, Cer, Ker, Cer, Wo, Wo, Wo, Wwg, Wwg, Ds, Ds, Ds, Gll, Gll, Ds, Ds, Ds, Gll, Ds, Gll^Fmf, Gll^Fmf, Gll^Fmf, Ds, Ds, Wwg, Ds, Ds, Wwg, Wwg, Wwg, Wog, Wog, Wog, Wog, Wog, Wog, Wog, Wog, Wog, Wog, Wog, Wog, Wog, Wog, Wog, Wog
Wog, Wog, Wog, Wog, Wog, Wog, Wog, Wog, Wog, Wog, Wog, Wog, Wog, Wog, Wog, Wog, Wog, Wog, Wog, Wog, Wwrg, Ds, Hd, Hd, Hd, Ds, Wwrg, Wwrg, Wwrg, Wwrg, Wwrg, Wwg, Wwg, Ds, Ds, Ds, Ds, Ds, Ds, Ds, Ds, Ds, Gll^Fmf, Gll^Fmf, Ds, Ds, Wwg, Ds, Ds, Gll^Fmf, Wwg, Wwg, Wwg, Wog, Wog, Wog, Wog, Wog, Wog, Wog, Wog, Wog, Wog, Wog, Wog, Wog, Wog, Wog
Wog, Wog, Wog, Wog, Wog, Wog, Wog, Wog, Wog, Wog, Wog, Wog, Wog, Wog, Wog, Wog, Wog, Wog, Wog, Wog, Wog, Wwrg, Ds, Ds, Hd, Hd, Ds, Ds, Wog, Wog, Wog, Wwg, Wwg, Wwg, Wwg, Ds, Wwg, Wwg, Wwg, Wwg, Wog, Ds, Ds, Gll^Fmf, Ds, Wwg, Wwg, Wwg, Ds, Gll, Gll, Wwg, Wwg, Wog, Wog, Wog, Wog, Wog, Wog, Wog, Wog, Wog, Wog, Wog, Wog, Wog, Wog, Wog
Wog, Wog, Wog, Wog, Wog, Wog, Wog, Wog, Wog, Wog, Wog, Wog, Wog, Wog, Wog, Wog, Wog, Wog, Wog, Wog, Wog, Wog, Wwrg, Ds, Wwrg, Hd, Ds, Ds, Wog, Wog, Wog, Wog, Wog, Wwg, Wog, Wwg, Wog, Wwg, Wog, Wog, Wog, Wog, Wog, Ds, Ds, Ds, Wwg, Wwg, Wwg, Ds, Ds, Gll^Fmf, Wwg, Wwg, Wog, Wog, Wog, Wog, Wog, Wog, Wog, Wog, Wog, Wog, Wog, Wog, Wog, Wog
Wog, Wog, Wog, Wog, Wog, Wog, Wog, Wog, Wog, Wog, Wog, Wog, Wog, Wog, Wog, Wog, Wog, Wog, Wog, Wog, Wog, Wwrg, Wwrg, Ds, Ds, Wwrg, Ds, Ds, Wog, Wog, Wog, Wog, Wog, Wog, Wog, Wog, Wog, Wog, Wog, Wog, Wog, Wog, Wog, Wog, Wog, Wwg, Wwg, Wwg, Wwg, Ds, Ds, Gll^Fmf, Wwg, Wwg, Wog, Wog, Wog, Wog, Wog, Wog, Wog, Wog, Wog, Wog, Wog, Wog, Wog, Wog
Wog, Wog, Wog, Wog, Wog, Wog, Wog, Wog, Wog, Wog, Wog, Wog, Wog, Wog, Ww, Wog, Wwg, Wog, Wog, Wog, Wog, Wwrg, Wwrg, Ds, Ds, Wwrg, Wog, Wog, Wog, Wog, Wog, Wog, Wog, Wog, Wog, Wog, Wog, Wog, Wog, Wog, Wog, Wog, Wog, Wog, Wog, Wog, Wog, Wwg, Wog, Wwg, Wwg, Ds, Ds, Wwg, Wog, Wog, Wog, Wog, Wog, Wog, Wog, Wog, Wog, Wog, Wog, Wog, Wog, Wog
Wog, Wog, Wog, Wog, Wog, Wog, Wog, Wog, Wog, Wog, Wog, Wog, Ww, Ww, Ds, Ds, Ds, Wwg, Wwg, Wwg, Wwg, Wwrg, Wwrg, Ds, Ds, Wwrg, Wwrg, Wog, Wog, Wog, Wog, Wog, Wog, Wog, Wog, Wog, Wog, Wog, Wog, Wog, Wog, Wog, Wog, Wog, Wog, Wog, Wog, Wog, Wog, Wog, Ds, Wwg, Ds, Wog, Wwg, Wog, Ds, Ds, Ds, Wwg, Wwg, Wog, Wog, Wog, Wog, Wog, Wog, Wog
Wog, Wog, Wog, Wog, Wog, Wog, Wog, Wog, Wog, Wog, Ww, Ww, Ww, Ds, Gll, Gll, Gll, Ds, Ds, Wwg, Wwg, Wwrg, Wwg, Wwg, Wwg, Ds, Wwrg, Wog, Wog, Wog, Wog, Wog, Wog, Wog, Wog, Wog, Wog, Wog, Wog, Wog, Wog, Wog, Wog, Wog, Wog, Wog, Wog, Wog, Ds, Ds, Ds, Ds, Ds, Ds, Ds, Ds, Gll^Fmf, Gll^Fmf, Gll^Fmf, Ds, Ds, Ds, Wwg, Wog, Wog, Wog, Wog, Wog
Wog, Wog, Wog, Wog, Wog, Wog, Wog, Wog, Ww, Ww, Ww, Ww, Ww, Ds, Gll, Gll, Gll, Gll, Gll, Ds, Ds, Wwg, Wwg, Wwg, Wwg, Wwg, Wwg, Chw^Edb, Chw^Edb, Chw^Edb, Chw^Edb, Wog, Wog, Wog, Wog, Wog, Wog, Wog, Wog, Wog, Wog, Wog, Wog, Wog, Wog, Wog, Wwg, Wwg, Ds, Ds, Gll, Gll, Gll, Gll, Gll, Gll, Gll, Hh^Fmf, Hh^Fmf, Hh^Fmf, Gll^Fmf, Ds, Ds, Wwg, Wwg, Wog, Wog, Wog
Wog, Wog, Wog, Wog, Wog, Wog, Wog, Wog, Ww, Ww, Ww, Ww, Ww, Ds, Gll, Gll, Hh, Gll, Gll, Gll, Gll, Ds, Ds, Wwg, Wwg, Wwg, Wwg, Wwg, Wwg, Wwg, Wwg, Wwg, Wog, Wog, Wog, Wog, Wog, Wog, Wog, Wog, Wog, Wog, Wog, Wog, Wog, Wog, Wwg, Ds, Gll, Gll, Gll^Fmf, Gll, Gll^Fmf, Gll, Gll, Gll, Gll, Gll^Fmf, Gll^Fmf, Hh^Fmf, Hh^Fmf, Gll, Gll, Ds, Ds, Wwg, Wog, Wog
Wog, Wog, Wog, Wog, Wog, Wog, Wog, Ww, Ww, Ww, Ww, Ww, Ds, Ds, Gll, Gll, Hh, Gll^Fmf, Gll^Fmf, Gll, Gll, Gll^Fmf, Ds, Wwg, Ds, Ds, Ds, Wwg, Wwg, Wwrg, Wwg, Wwg, Wwg, Wog, Wog, Wog, Wog, Wog, Wog, Wog, Wog, Wog, Wog, Wog, Wog, Wog, Wwg, Ds, Ds, Gll, Hh^Fmf, Hh^Fmf, Ss, Gll^Fmf, Ss, Ss, Ss, Ss, Gll^Fmf, Gll^Fmf, Gll^Fmf, Gll^Fmf, Gll^Fmf, Gll^Fmf, Ds, Wwg, Wog, Wog
Wog, Wog, Wog, Wog, Wog, Wog, Ww, Ww, Ww, Ww, Ds, Ds, Ss, Ss, Ss, Hh^Fmf, Hh^Fmf, Hh^Fmf, Hh, Gll, Gll, Gll^Fmf, Gll^Fmf, Ds, Gll^Fmf, Gll^Fmf, Gll, Ds, Wwrg, Wwrg, Wwrg, Wwg, Wwg, Wog, Wog, Wog, Wog, Wog, Wog, Wog, Wog, Wog, Wog, Wog, Wog, Wog, Ds, Ds, Ds, Gll, Hh^Fmf, Hh^Fmf, Ss, Ss, Ds, Ds, Ds, Ds, Ds, Ds, Ds, Gll, Ds, Ds, Wwg, Wwg, Wog, Wog
Wog, Wog, Wog, Wog, Wog, Ww, Ww, Ww, Ds, Ds, Gll, Gll, Ss, Gll^Fmf, Gll^Fmf, Gll^Fmf, Hh^Fmf, Hh^Fmf, Hh^Fmf, Gd^Vhr, Gll, Gll, Gll, Gll^Fmf, Gll, Gll, Gll, Ds, Wwf, Wwrg, 1 Wwrg, Wwg, Wwg, Wog, Wog, Wog, Wog, Wog, Wog, Wog, Wog, Wog, Wog, Wog, Wog, Wwg, Ds, Ds, Gll, Gll, Hh^Vhhr, Gll^Fmf, Ss, Ss, Wwg, Ds, Ds, Ds, Wwr, Ds, Wwr, Ds, Wwr, Ds, Wog, Wog, Wog, Wog
Wog, Wog, Wog, Wog, Wog, Ww, Ww, Ww, Ds, Gll, Gll, Gll, Gll^Fmf, Gll^Fmf, Hh^Fmf, Hh^Fmf, Hh^Fmf, Hh^Fmf, Gll^Fmf, Gll^Fmf, Gll, Gll, Gll, Gll, Gll, Gll, Wwf, Wwf, Wwf, Wwf, Wwrg, Wwrg, Wwg, Wog, Wog, Wog, Wog, Wog, Wog, Wog, Wog, Wog, Wog, Wog, Wog, Wwg, Wwg, Ds, Gll, Hh^Fmf, Hh^Fmf, Ss, Ss, Cme, 4 Kme, Wwg, Wwg, Wwg, Wwg, Wwg, Wwg, Wwr, Wog, Wog, Wog, Wog, Wog, Wog
Wog, Wog, Wog, Wog, Wog, Ww, Ww, Ww, Ds, Gll, Gll, Gll^Fmf, Gll^Fmf, Hh^Fmf, Gll^Fmf, Gll^Fmf, Gll^Fmf, Gll^Fmf, Gll^Fmf, Ss, Ss, Gll, Gll, Gll, Gll, Gd^Vhr, Chr^Edb, Chw^Edb, Wwg, Wwg, Wwg, Wwg, Wwg, Wog, Wog, Wog, Wog, Wog, Wog, Wog, Wog, Wog, Wog, Wog, Wog, Wwg, Wwg, Ds, Gll, Gll^Fmf, Hh^Fmf, Gll^Fmf, Ss, Cme, Cme, Cme, Cme, Wwg, Wwg, Wwg, Wwg, Wwg, Wwg, Wog, Wog, Wog, Wog, Wog
Wog, Wog, Wog, Wog, Wog, Ww, Ww, Ww, Ds, Gll, Gll, Gll, Gll^Fmf, Gll^Fmf, Gll^Fmf, Gd^Vhr, Ss, Gll^Fmf, Gll^Fmf, Gll^Fmf, Ss, Gll, Gll^Fmf, Gll, Gll, Gll, Chr^Edb, Chw^Edb, Khw, Wwg, Wwg, Wwg, Wwg, Wog, Wog, Wog, Wog, Wog, Wo^Vm, Wog, Wog, Wog, Wog, Wog, Wog, Wwg, Wwg, Ds, Gll, Gll, Gll^Fmf, Hh^Fmf, Gll^Fmf, Ss, Ss, Ss, Ss, Gll, Gll, Gll, Gll, Wwg, Wwg, Wwg, Wog, Wog, Wog, Wog
Wog, Wog, Wog, Wog, Wog, Ww, Ww, Ww, Ww, Ds, Ds, Gll, Gll, Ss, Ss, Ss, Gll, Ss, Ss, Gll^Fmf, Gll^Fmf, Ss, Gll^Fmf, Gll, Gll, Gll, Gll, Ds, Wwg, Wwg, Wwg, Wwg, Wog, Wog, Wog, Wog, Wog, Wog, Wog, Wog, Wog, Wog, Wog, Wog, Wog, Wwg, Wwg, Wwg, Gll, Ds, Gll, Gll^Fmf, Gll^Fmf, Gll^Fmf, Gll^Fmf, Gll^Fmf, Gll^Fmf, Gll, Gll, Gll, Gll, Ds, Wwg, Wwg, Wog, Wog, Wog, Wog
Wog, Wog, Wog, Wog, Wog, Ww, Ww, Ww, Ww, Ww, Ds, Gll, Gll, Gll, Gll, Gll, Gll, Ss, Gll, Gll^Fmf, Gll^Fmf, Hh^Fmf, Hh^Fmf, Hh^Fmf, Hh^Fmf, Gll^Fmf, Gll^Fmf, Ds, Wwg, Wwg, Wwg, Wwg, Wog, Wog, Wog, Wog, Wog, Wog, Wog, Wog, Wog, Wog, Wog, Wog, Wog, Wog, Wog, Wwg, Wwg, Ds, Ds, Gll, Gll, Gll^Fmf, Gll, Gll^Fmf, Gll^Fmf, Gll^Fmf, Gll, Gll, Gll, Ds, Wwg, Wwg, Wog, Wog, Wog, Wog
Wog, Wog, Wog, Wog, Wog, Wog, Ww, Ww, Ww, Ww, Ds, Gll, Gll, Gll, Gll, Gll, Gll, Gll, Gll, Gll, Gll, Gll^Fmf, Ds, Hh^Fmf, Hh^Fmf, Hh^Fmf, Gll^Fmf, Ds, Wwr, Wwg, Wog, Wog, Wog, Wog, Wog, Wog, Wog, Wog, Wog, Wog, Wog, Wog, Wog, Wog, Wog, Wog, Wog, Wog, Wog, Wwg, Wwg, Ds, Ds, Ds, Ds, Gll, Gll, Gll, Gll, Gll, Ds, Ds, Wwg, Wwg, Wog, Wog, Wog, Wog
Wog, Wog, Wog, Wog, Wog, Wog, Ww, Ww, Ww, Ww, Ww, Ds, Ds, Ds, Ds, Gll, Gll, Gll, Gll, Gll, Ds, Ds, Wwr, Ds, Ds, Gll^Fmf, Ds, Ds, Wwr, Wwr, Wog, Wog, Wog, Wog, Wog, Wog, Wog, Wog, Wog, Wog, Wog, Wog, Wog, Wog, Wog, Wog, Wog, Wog, Wog, Wog, Wog, Wwg, Wwg, Gll, Ds, Ds, Ds, Ds, Ds, Ds, Ds, Wwg, Wog, Wog, Wog, Wog, Wog, Wog
Wog, Wog, Wog, Wog, Wog, Wog, Wog, Ww, Ww, Ww, Ww, Ww, Ww, Ww, Ww, Ds, Ds, Ds, Ds, Ds, Wwr, Wwr, Wwr, Wwr, Wwr, Ds, Wwr, Wwr, Ww, Ww, Wog, Wog, Wog, Wog, Wog, Wog, Wog, Wog, Wog, Wog, Wog, Wog, Wog, Wog, Wog, Wog, Wog, Wog, Wog, Wog, Wog, Wog, Wog, Wwg, Wwg, Ds, Wwg, Wwg, Wwg, Wwg, Wog, Wog, Wog, Wog, Wog, Wog, Wog, Wog
Wog, Wog, Wog, Wog, Wog, Wog, Wog, Wog, Wog, Ww, Ww, Ww, Ww, Ww, Ww, Ww, Wog, Ww, Wog, Wwr, Wwr, Ww, Ww, Ww, Ww, Wwr, Wwr, Wwr, Wog, Wog, Wog, Wog, Wog, Wog, Wog, Wog, Wog, Wog, Wog, Wog, Wog, Wog, Wog, Wog, Wog, Wog, Wog, Wog, Wog, Wog, Wog, Wog, Wog, Wog, Wog, Wwg, Wog, Wwg, Wog, Wog, Wog, Wog, Wog, Wog, Wog, Wog, Wog, Wog
Wog, Wog, Wog, Wog, Wog, Wog, Wog, Wog, Wog, Wog, Wog, Ww, Wog, Ww, Wog, Wog, Wog, Wog, Wog, Wog, Wog, Wog, Wog, Wog, Wog, Wog, Wog, Wog, Wog, Wog, Wog, Wog, Wog, Wog, Wog, Wog, Wog, Wog, Wog, Wog, Wog, Wog, Wog, Wog, Wog, Wog, Wog, Wog, Wog, Wog, Wog, Wog, Wog, Wog, Wog, Wog, Wog, Wog, Wog, Wog, Wog, Wog, Wog, Wog, Wog, Wog, Wog, Wog
Wog, Wog, Wog, Wog, Wog, Wog, Wog, Wog, Wog, Wog, Wog, Wog, Wog, Wog, Wog, Wog, Wog, Wog, Wog, Wog, Wog, Wog, Wog, Wog, Wog, Wog, Wog, Wog, Wog, Wog, Wog, Wog, Wog, Wog, Wog, Wog, Wog, Wog, Wog, Wog, Wog, Wog, Wog, Wog, Wog, Wog, Wog, Wog, Wog, Wog, Wog, Wog, Wog, Wog, Wog, Wog, Wog, Wog, Wog, Wog, Wog, Wog, Wog, Wog, Wog, Wog, Wog, Wog
Wog, Wog, Wog, Wog, Wog, Wog, Wog, Wog, Wog, Wog, Wog, Wog, Wog, Wog, Wog, Wog, Wog, Wog, Wog, Wog, Wog, Wog, Wog, Wog, Wog, Wog, Wog, Wog, Wog, Wog, Wog, Wog, Wog, Wog, Wog, Wog, Wog, Wog, Wog, Wog, Wog, Wog, Wog, Wog, Wog, Wog, Wog, Wog, Wog, Wog, Wog, Wog, Wog, Wog, Wog, Wog, Wog, Wog, Wog, Wog, Wog, Wog, Wog, Wog, Wog, Wog, Wog, Wog
Wog, Wog, Wog, Wog, Wog, Wog, Wog, Wog, Wog, Wog, Wog, Wog, Wog, Wog, Wog, Wog, Wog, Wog, Wog, Wog, Wog, Wog, Wog, Wog, Wog, Wog, Wog, Wog, Wog, Wog, Wog, Wog, Wog, Wog, Wog, Wog, Wog, Wog, Wog, Wog, Wog, Wog, Wog, Wog, Wog, Wog, Wog, Wog, Wog, Wog, Wog, Wog, Wog, Wog, Wog, Wog, Wog, Wog, Wog, Wog, Wog, Wog, Wog, Wog, Wog, Wog, Wog, Wog
Wog, Wog, Wog, Wog, Wog, Wog, Wog, Wog, Wog, Wog, Wog, Wog, Wog, Wog, Wog, Wog, Wog, Wog, Wog, Wog, Wog, Wog, Wog, Wog, Wog, Wog, Wog, Wog, Wog, Wog, Wog, Wog, Wog, Wog, Wog, Wog, Wog, Wog, Wog, Wog, Wog, Wog, Wog, Wog, Wog, Wog, Wog, Wog, Wog, Wog, Wog, Wog, Wog, Wog, Wog, Wog, Wog, Wog, Wog, Wog, Wog, Wog, Wog, Wog, Wog, Wog, Wog, Wog
