Wo, Wo, Wo, Wo, Wo, Wo, Wo, Wo, Wo, Wo, Wo, Wo, Wo, Wo, Wo, Wo, Wo, Wo, Wo, Wo, Wo, Wo, Wo, Wo, Wo, Wo, Wo, Wo, Wo, Wo, Wo, Wo, Wo, Wo, Wo, Wo, Wo, Wo, Wo, Wo, Wo, Wo, Wo, Wo, Ww, Ds, Ds, Gll^Fmf, Hh^Fmf, Hh^Fmf, Hh^Fmf, Hh^Fmf, Hh^Fmf, Hh^Fmf, Hh^Fmf, Hh^Fmf, Hh^Fmf, Hh^Fmf, Hh^Fmf, Gll^Fmf, Hh^Fmf, Gll^Fmf, Gll^Fmf, Gll^Fmf, Gll^Fmf, Gll^Fmf, Gll^Fmf, Gll
Wo, Wo, Wo, Wo, Wo, Wo, Wo, Wo, Wo, Wo, Wo, Wo, Wo, Wo, Wo, Wo, Wo, Wo, Wo, Wo, Wo, Wo, Wo, Wo, Wo, Wo, Wo, Wo, Wo, Wo, Wo, Wo, Wo, Wo, Wo, Wo, Wo, Wo, Wo, Wo, Wo, Wo, Wo, Wo, Ww, Ww, Ww, Ds, Ds, Hh^Fmf, Gll^Fmf, Hh^Fmf, Gll^Fmf, Hh^Fmf, Gll^Fmf, Gll^Fmf, Gll^Fmf, Hh^Fmf, Gll^Fmf, Hh^Fmf, Gll, Gll, Gg^Ve, Gll, Gll, Gll^Fmf, Gll, Gll
Wo, Wo, Wo, Wo, Wo, Wo, Wo, Wo, Wo, Wo, Wo, Wo, Wo, Wo, Wo, Wo, Wo, Wo, Wo, Wo, Wo, Wo, Wo, Wo, Wo, Wo, Wo, Wo, Wo, Wo, Wo, Wo, Wo, Wo, Wo, Wo, Wo, Wo, Wo, Wo, Wo, Wo, Wo, Wo, Ww^Vm, Ww, Ww, Dd^Ftd, Dd^Ftd, Ds, Ds, Gll^Fmf, Gll^Fmf, Gll^Fmf, Gll, Gg^Ve, Gll, Gll, Gll, Gll, Gll, Gll, Gll, Gll, Gll, Gll, Gll^Fmf, Gll^Fmf
Wo, Wo, Wo, Wo, Wo, Wo, Wo, Wo, Wo, Wo, Wo, Wo, Wo, Wo, Wo, Wo, Wo, Wo, Wo, Wo, Wo, Wo, Wo, Wo, Wo, Wo, Wo, Wo, Wo, Wo, Wo, Wo, Wo, Wo, Wo, Wo, Wo, Wo, Wo, Wo, Wo, Wo, Wo, Wo, Wo, Ww, Ww, Dd^Ftd, Dd^Ftd, Dd^Ftd, Ds, Ds, Ds, Gll^Fmf, Gll, Gll, Gll, Gll, Gll, Gll, Gll, Gll, Gll, Gll, Gll, Gll, Gll^Fmf, Hh^Fmf
Wo, Wo, Wo, Wo, Wo, Wo, Wo, Wo, Wo, Wo, Wo, Wo, Wo, Wo, Wo, Wo, Wo, Wo, Wo, Wo, Wo, Wo, Wo, Wo, Wo, Wo, Wo, Wo, Wo, Wo, Wo, Wo, Wo, Wo, Wo, Wo, Wo, Wo, Wo, Wo, Wo, Wo, Wo, Wo, Wo, Wo, Cm, Ww, Wwr, Wwf, Wwr, Wwf, Wwf, Ds, Ds, Gll, Ds, Gll, Gll, Gll, Gll, Gll, Gll^Fmf, Gll, Gll^Fmf, Gll, Hh^Fmf, Hh^Fmf
Wo, Wo, Wo, Wo, Wo, Wo, Wo, Wo, Wo, Wo, Wo, Wo, Wo, Wo, Cme, Wo, Wo, Wo, Wo, Wo, Wo, Wo, Wo, Wo, Wo, Wo, Wo, Wo, Wo, Wo, Wo, Wo, Wo, Wo, Wo, Wo, Wo, Wo, Wo, Wo, Wo, Wo, Wo, Wo, Wo, Cm, 3 Km, Cm, Wwf, Wwr, Ww^Ewf, Wwr, Wwf, Wwf, Wwf, Ds, Wwf, Ds, Ds, Gll, Ds, Gll^Fmf, Ds, Gll^Fmf, Gll^Fmf, Gg^Ve, Gll^Fmf, Hh^Fmf
Wo, Wo, Wo, Wo, Wo, Wo, Wo, Wo, Wo, Wo, Wo, Wo, Wo, Cme, 2 Kme, Cme, Wo, Wo, Wo, Wo, Wo, Wo, Wo, Wo, Wo, Wo, Wo, Wo, Wo, Wo, Wo, Wo, Wo, Wo, Wo, Wo, Wo, Wo, Wo, Wo, Wo, Wo, Wo, Wo, Wo, Cm, Cm, Ww, Wwf, Wwr, Wwr, Wwr, Wwf, Wwf, Wwf, Wwf, Wwf, Wwf, Wwf, Ds, Wwf, Ds, Wwf, Ds, Gll^Fmf, Gll^Fmf, Hh^Fmf, Hh^Fmf
Wo, Wo, Wo, Wo, Wo, Wo, Wo, Wo, Wo, Wo, Wo, Wo, Ww, Cme, Ww, Cme, Ww, Wo, Wo, Wo, Wo, Wo, Wo, Wo, Wo, Wo, Wo, Wo, Wo, Wo, Wo, Wo, Wo, Wo, Wo, Wo, Wo, Wo, Wo, Wo, Wo, Wo, Ww, Wo, Ww, Wo, Wo, Wwf, Wwr, Wwf, Wwf, Wwf, Wwf, Wwf, Wwf, Wwf, Wwf, Wwf, Wwf, Wwf, Wwf, Wwf, Wwf, Ds, Gll^Fmf, Hh^Fmf, Hh^Fmf, Hh^Fmf
Wo, Wo, Wo, Wo, Wo, Wo, Wo, Wo, Wo, Wo, Wo, Ww, Ww, Ww, Ww, Ww, Ww, Ww, Ww, Ww^Vm, Ww, Ww, Ww, Wo, Wo, Wo, Wo, Wo, Wo, Wo, Wo, Wo, Wo, Wo, Wo, Wo, Wo, Wo, Wo, Wo, Ww, Ww, Ww, Ww^Vm, Ww, Ww, Ww, Wwf, Wwr, Wwr, Wwf, Wwf, Wwf, Wwf, Wwf, Wwf, Wwf, Wwf, Wwf, Wwf, Wwf, Wwf, Wwf, Ds, Gll^Fmf, Hh^Fmf, Hh^Fmf, Hh^Fmf
Wo, Wo, Wo, Wo, Wo, Wo, Wo, Wo, Wo, Wo, Ww, Ww, Ww, Ww, Ds, Ds, Ds, Ds, Ds, Ds, Ds, Ww, Ww, Ww, Ww, Wo, Wo, Wo, Wo, Wo, Wo, Wo, Wo, Wo, Wo, Wo, Ww, Ww, Ww, Wo, Ww, Ww, Ww, Ww, Ds, Ds, Ds, Ds, Ds, Wwr, Wwf, Wwf, Wwf, Wwf, Wwf, Wwf, Wwf, Wwf, Wwf, Wwf, Wwf, Wwf, Wwf, Ds, Gll^Fmf, Gll^Fmf, Hh^Fmf, Hh^Fmf
Wo, Wo, Wo, Wo, Wo, Wo, Wo, Wo, Ww^Vm, Ww, Ww, Ww, Ds, Ds, Gll^Fmf, Gll^Fmf, Gll^Fmf, Gll^Fmf, Gll^Fmf, Gll^Fmf, Gll^Fmf, Ds, Ds^Edb, Ww, Ww, Ww, Ww, Wo, Wo, Wo, Wo, Wo, Ww, Wo, Ww, Ww, Ww, Ww, Ww, Ww, Ds, Ww, Ds, Ds, Gll^Fmf, Gll^Fmf, Gll^Fmf, Ds, Gll^Fmf, Ds, Ds, Wwf, Ds, Wwf, Wwf, Wwf, Wwf, Wwf, Wwf, Wwf, Wwf, Wwf, Wwf, Ds, Gll^Fmf, Hh^Fmf, Hh^Fmf, Hh^Fmf
Wo, Wo, Wo, Wo, Wo, Wo, Wo, Wo, Ww, Ww, Ww, Ds, Hh^Fmf, Hh^Fmf, Hh^Fmf, Gll^Fmf, Gll^Em, Gll^Fmf, Gll, Gll^Fmf, Gll^Fmf, Gll^Edb, Gll^Edb, Ds^Edb, Ds^Edb, Ww, Ww, Ww, Wo, Wo, Wo, Wo, Ww, Ww, Ww, Ww, Ww, Ww, Ds, Ds, Gll^Fmf, Ds, Gll^Fmf, Ds, Ss, Gll^Fmf, Gll^Fmf, Gll^Fmf, Gll^Fmf, Gll, Gll, Ds, Gll^Fmf, Ds, Ds, Wwf, Wwf, Wwf, Wwf, Wwf, Wwf, Wwf, Wwf, Ds, Ds, Hh^Fmf, Hh^Fmf, Hh^Fmf
Wo, Wo, Wo, Wo, Wo, Wo, Wo, Wo, Wo, Ww, Ww, Ds, Hh^Fmf, Hh^Fmf, Gll^Em, Gll^Em, Gll, Gll, Gll, Gll, Gll^Edb, Gll^Edb, Gll^Edb, Gll^Edb, Ds, Ww, Ww, Ww, Ww, Wo, Ww, Ww, Ww, Ww, Ww, Ww, Ds, Ds, Gll^Fmf, Gll^Fmf, Hh^Fmf, Gll^Fmf, Hh^Fmf, Ss, Chs, Ss, Hh^Fmf, Gll^Fmf, Gll^Fmf, Gll, Gll, Gll, Gll, Gll^Fmf, Ds, Wwf, Wwf, Wwf, Wwf, Wwf, Wwf, Wwf, Wwf, Ww, Ww, Ds, Ds, Hh^Fmf
Wo, Wo, Wo, Wo, Wo, Wo, Wo, Wo, Wo, Ww, Ww, Ds, Hh^Fmf, Hh^Fmf, Gll^Em, Gll^Em, Gll, Gll, Gll, Gll, Gll^Edb, Gll^Edb, Gll^Edb, Gll^Fmf, Gll^Fmf, Ds, Ds, Ww, Ww, Wo, Ww, Ww, Ww, Ww, Ww, Ww, Ds, Gll^Fmf, Gll^Fmf, Gll^Fmf, Hh^Fmf, Hh^Fmf, Hh^Fmf, Hh^Fmf, Khs, Ss, Hh^Fmf, Hh^Fmf, Hh^Fmf, Gll^Fmf, Gll, Gll, Gll^Fmf, Gll^Fmf, Ds, Wwf, Wwf, Wwf, Wo, Wo, Ww, Wwf, Ww, Ww, Ww, Ww, Ww, Ds
Wo, Wo, Wo, Wo, Wo, Wo, Wo, Wo, Wo, Ww, Ww, Ds, Gll^Fmf, Gll^Fmf, Gll^Fmf, Gll^Em, Gll, Gll, Gll, Gll, Gll^Fmf, Gll^Edb, Gd^Vhr, Gll^Fmf, Gll^Fmf, Gll^Fmf, Gll^Fmf, Ds, Ww, Ww, Ww, Ww, Ww, Ww, Ww, Ww, Ds, Gll^Fmf, Wwf, Gll^Fmf, Gll^Fmf, Hh^Fmf, Hh^Fmf, Chs, Hh^Fmf, Chs, Ss, Hh^Fmf, Hh^Fmf, Hh^Vhhr, Gll, Gll, Gll^Fmf, Ds, Ww, Ww, Ww, Wo, Wo, Wo, Wo, Ww, Wo, Wo, Wo, Ww, Ww, Ww
Wo, Wo, Wo, Wo, Wo, Wo, Wo, Wo, Ww, Ww, Ww, Ds, Ds, Gll^Fmf, Gll^Fmf, Gll^Em, Gll^Em, Gll, Gll, Ss, Ss, Gll^Fmf, Gll^Fmf, Gll^Fmf, Hh^Fmf, Gll^Fmf, Gll^Fmf, Ds, Ww, Ww, Ww, Ww, Ww, Ww, Ww, Ww, Wwf, Wwf, Wwf, Wwf, Gll, Wwf^Edb, Ss^Edb, Ss^Edb, Ss^Edb, Hh^Fmf, Wwf^Edb, Hh^Fmf, Gll^Fmf, Gll, Gll, Gll, Gll^Fmf, Ds, Ww, Ww, Wo, Wo, Wo, Wo, Wo, Wo, Wo, Wo, Wo, Ww, Ww, Ww
Wo, Wo, Wo, Wo, Wo, Wo, Wo, Wo, Ww, Ww, Ww, Ds, Gll^Fmf, Gll^Fmf, Ss, Ss, Ss, Ss, Gll, Gll^Fmf, Ss, Ss, Ss, Hh^Fmf, Hh^Fmf, Hh^Fmf, Gll^Fmf, Ds, Ww, Ww, Ww, Ww, Ww, Ww, Wwf, Wwf, Wwf, Wwf, Wwf, Wwf, Ds, Wwf^Edb, Wwf^Edb, Ss^Edb, Gll^Edb, Wwf^Edb, Wwf^Edb, Gll, Gll, Gll, Gll, Gll, Ds, Ds, Ww, Ww, Wo, Wo, Wo, Wo, Wo, Wo, Wo, Wo, Wo, Ww, Ww, Ww
Wo, Wo, Wo, Wo, Wo, Wo, Ww, Ww, Ww, Ww, Ds, Ds, Gll^Fmf, Gll^Fmf, Ss, Ss, Ss, Gll, Gll, Ss, Ss, Ss, Ss, Gll^Fmf, Gll^Fmf, Hh^Fmf, Gll^Fmf, Ds, Ds, Ww, Wwf, Wwf, Wwf, Ds, Ds, Wwf, Wwf, Wwf, Wwf, Wwf, Ww, Ds, Ds, Gll^Edb, Ds, Ds^Edb, Ds, Gll, Gll, Gll, Ds, Ds, Ww, Ww, Ww, Ww, Wo, Wo, Wo, Wo, Wo, Wo, Wo, Wo, Wo, Wo, Wo, Ww
Wo, Wo, Wo, Wo, Wo, Wo, Ww, Ww, Ww, Ds, Gll^Fmf, Gll^Fmf, Hh^Fmf, Gll^Fmf, Ss, Ss, Ss, Ss, Gll, Ss, Ss, Ss, Ss, Ss, Gll^Fmf, Hh^Fmf, Gll^Fmf, Gll^Fmf, Wwf, Wwf, Wwf, Wwf, Wwf, Ds, Ds, Wwf, Wwf, Wwf, Ww, Ww, Ww, Ww, Ww, Ds, Ww, Ww, Ww, Ds, Ds, Ds, Ww, Ww, Ww, Ww, Ww, Ww, Wo, Wo, Wo, Wo, Wo, Wo, Wo, Wo, Wo, Wo, Wo, Wo
Wo, Wo, Wo, Wo, Wo, Wo, Ww, Ww, Ww, Ds, Gll^Fmf, Hh^Fmf, Gll^Fmf, Gll^Fmf, Ss, Ss, Ss, Ss, Ss, Gll, Ss, Ss, Ss, Ss, Hh^Fmf, Hh^Fmf, Gll^Fmf, Gll, Wwf, Wwf, Wwf, Wwf, Wwf, Ds, Wwr, Wwr, Ww, Ww, Wwr, Wwr, Ww, Ww, Ww, Ww, Ww, Ww, Ww, Ww, Ww, Ww, Ww, Ww, Ww, Ww, Wo, Wo, Wo, Wo, Wo, Wo, Wo, Wo, Wo, Wo, Wo, Wo, Wo, Wo
Wo, Wo, Wo, Wo, Ww, Ww, Ww, Ww, Ds, Ds, Hh^Fmf, Hh^Fmf, Gll^Fmf, Gll^Fmf, Gll^Fmf, Gll^Fmf, Gll^Fmf, Ss, Gll^Fmf, Gll, Gll^Fmf, Ss, Ss, Gll^Fmf, Hh^Fmf, Hh^Fmf, Hh^Fmf, Gll, Gll, Wwf, Ds, Wwf, Ww, Ww, Wwr, Wwr, Wwr, Wwr, Ww, Wwr, Chw, Ww, Ww, Ww, Ww, Ww, Ww, Ww, Ww, Ww, Ww, Ww, Ww, Ww, Ww, Wo, Wo, Wo, Wo, Wo, Wo, Wo, Wo, Wo, Wo, Wo, Wo, Wo
Wo, Wo, Wo, Wo, Ww, Ww, Ds, Ds, Gll^Fmf, Hh^Fmf, Hh^Fmf, Gll^Fmf, Gll, Gll, Gll, Gll, Gll, Gll, Gll, Gll, Gll^Fmf, Ss, Gll^Fmf, Gll^Fmf, Hh^Fmf, Hh^Fmf, Hh^Fmf, Gll, Gll^Fmf, Gll^Fmf, Ds, Ww, Ww, Ww, Ww, Wwr, Ww, Ww, Ww, Ww, Ww, Ww, Ww, Ww, Ww, Ww, Ww, Ww, Ww, Ww, Ww, Ww, Ww, Ww, Ww, Wo, Wo, Wo, Wo, Wo, Wo, Wo, Wo, Wo, Wo, Wo, Wo, Wo
Wo, Wo, Wo, Wo, Ww, Ww, Ds, Gll^Fmf, Hh^Fmf, Hh^Fmf, Gll, Gll, Gll, Gll, Gll, Gll^Fmf, Gll^Fmf, Gll, Gll^Fmf, Gll, Gd^Vhr, Ss, Ss, Gll^Fmf, Gll^Fmf, Hh^Fmf, Gll, Gll, Ds, Gll^Fmf, Ww, Ww, Ww, Ww, Ww, Ww, Ww, Ww, Ww, Ww, Ww, Ww, Ww, Ww, Ww, Ww, Ww, Ww, Ww, Ww, Ww, Ww, Ww, Ww, Wo, Wo, Wo, Wo, Wo, Wo, Wo, Wo, Wo, Wo, Wo, Wo, Wo, Wo
Wo, Wo, Wo, Wo, Wo, Ww, Ds, Hh^Fmf, Gll^Fmf, Gll^Fmf, Gll, Gll, Gll, Gll, Gll^Fmf, Gll^Fmf, Gll^Fmf, Gll^Fmf, Gll^Fmf, Gll, Gll, Gll^Fmf, Gll, Gll^Fmf, Gll, Gll, Ww, Ww, Ww, Ww, Ds, Ww, Ww, Ww, Ww, Ww, Wwf, Ww, Ww, Ww, Ww, Ww, Ww, Ww, Ww, Ww, Ww, Ww^Vm, Ww, Ww, Ww, Ww, Wo, Wo, Wo, Wo, Wo, Wo, Wo, Wo, Wo, Wo, Wo, Wo, Wo, Wo, Wo, Wo
Wo, Wo, Wo, Wo, Ww, Ww, Ww, Ds, Gll^Fmf, Gd^Vhr, Gll, Gll, Gll^Fmf, Gll^Fmf, Gll^Fmf, Gll^Fmf, Ww, Ww^Vm, Chw, Gll, Chw, Gll, Ss, Gll, Ww, Ww, Ww, Ww, Ww, Ds, Gll^Fmf, Ds, Wwf, Wwf, Wwf, Wwf, Wwf, Wwf^Edb, Ww, Ww, Ww, Ww, Ww, Ww, Ww, Ww, Ww, Ww, Ww, Ww, Ww, Ww, Ww, Wo, Wo, Wo, Wo, Wo, Wo, Wo, Wo, Wo, Wo, Wo, Wo, Wo, Wo, Wo
Wo, Wo, Wo, Wo, Wo, Ww, Ww, Ds, Hh^Fmf, Hh^Fmf, Gll^Fmf, Gll, Gll^Fmf, Gll^Fmf, Ww, Ww, Ww, Ww, Ww, Ww^Bw|r, Ww, Ww, Ww, Ww, Ww, Ww, Ww, Ww, Ww, Gll^Fmf, Gll^Fmf, Ds, Wwf, Wwf, Wwf, Wwf, Wwf^Edb, Wwf^Edb, Wwf^Edb, Ww, Ww, Ww, Ww, Ww, Ww, Ww, Ww, Ww, Ww, Ww, Ww, Ww, Ww, Ww, Wo, Wo, Wo, Wo, Wo, Wo, Wo, Wo, Wo, Wo, Wo, Wo, Wo, Wo
Wo, Wo, Wo, Wo, Wo, Ww, Ww, Ds, Hh^Fmf, Hh^Fmf, Hh^Fmf, Gll^Fmf, Hh^Fmf, Gll^Fmf, Ww, Ww, Ww, Ww, Gll^Fmf, Gll, Gll, Ww, Gll^Fmf, Ww, Ww, Ww, Gll^Fmf, Ww, Ss, Gll^Fmf, Gll^Fmf, Gll^Fmf, Ds, Wwf, Wwf, Wwf^Edb, Chw, Khw, Chw, Wwf^Edb, Wwf, Ww, Ww, Ww, Ww, Ww, Ww, Ww, Ww, Ww, Ww, Ww, Ww, Ww, Wo, Wo, Wo, Wo, Wo, Wo, Wo, Wo, Wo, Wo, Wo, Wo, Wo, Wo
Wo, Wo, Wo, Wo, Wo, Ww, Ww, Ds, Gll^Fmf, Hh^Fmf, Gll^Fmf, Hh^Fmf, Gll^Fmf, Gll^Fmf, Ww, Ww, Ww, Ww, Hh^Fmf, Hh^Fmf, Gll, Gll^Fmf, Gll^Fmf, Gll^Fmf, Gll^Fmf, Gll^Fmf, Gll^Fmf, Ss, Ss, Ss, Ss, Gll^Fmf, Gll^Fmf, Wwf, Wwf, Ds^Edb, Gll^Edb, Gll^Edb, Gll^Edb, Ds^Edb, Wwf, Wwf, Wwf, Wwf, Wwf, Ww, Ww, Ww, Ww, Ww, Ww, Ww, Ww, Ww, Cme, Wo, Wo, Wo, Wo, Wo, Wo, Wo, Wo, Wo, Wo, Wo, Wo, Wo
Wo, Wo, Wo, Wo, Ww, Ww, Ww, Ds, Ds, Gll^Fmf, Ww, Gll^Fmf, Ww, Ww, Ww, Ww, Ww, Gll^Fmf, Hh^Fmf, Gll, Gll^Fmf, Hh^Fmf, Hh^Fmf, Gll^Fmf, Gll^Fmf, Gll^Fmf, Gll^Fmf, Ss, Ss, Ss, Gll^Fmf, Gll^Fmf, Ds, Wwf, Wwf, Ds, Gll^Fmf, Gd^Vhr, Ds, Ds, Wwf, Wwf, Wwf, Wwf, Wwf, Wwf, Ww, Ww, Ww, Ww, Ww, Ww, Ww, 4 Kme, Cme, Wo, Wo, Wo, Wo, Wo, Wo, Wo, Wo, Wo, Wo, Wo, Wo, Wo
Wo, Wo, Wo, Wo, Ww, Ww, Ww, Ww, Ww, Ww, Ww, Ww, Ww, Ww, Ww, Ww, Gll^Fmf, Gll^Fmf, Hh^Fmf, Gll, Gll^Fmf, Hh^Fmf, Hh^Fmf, Hh^Fmf, Hh^Fmf, Hh^Fmf, Gll, Hh^Fmf, Gll, Gll^Fmf, Gll^Fmf, Gll^Fmf, Wwf, Wwf, Wwf, Ds, Ds, Gll^Fmf, Ds, Wwf, Wwf, Wwf, Wwf, Wwf, Wwf, Wwf, Ww, Ww, Ww, Ww, Ww, Ww, Cme, Cme, Ww, Ww, Ww, Wo, Wo, Wo, Wo, Wo, Wo, Wo, Wo, Wo, Wo, Wo
Wo, Wo, Wo, Wo, Ww, Ww, Ww, Ds, Gll^Fmf, Ww, Gll^Fmf, Ww, Gll^Fmf, Ww, Gll^Fmf, Gll^Fmf, Hh^Fmf, Hh^Fmf, Gll, Gll, Chr, Gll^Fmf, Gll^Fmf, Hh^Fmf, Gll, Gll, Gll, Gll, Gll, Gll, Gll, Gll, Wwf, Wwf, Wwf, Wwf, Wwf, Ds, Wwf, Wwf, Wwf, Wwf, Ds, Ds, Hh^Fmf, Ds, Ds, Ww, Ww, Ww, Ww, Ww, Ds, Ww, Ww, Ww, Ww, Ww, Ww, Wo, Wo, Wo, Wo, Wo, Wo, Wo, Wo, Wo
Wo, Wo, Wo, Wo, Wo, Ww, Ww, Ds, Ds, Gll^Fmf, Gll^Fmf, Gll^Fmf, Hh^Fmf, Gll^Fmf, Hh^Fmf, Hh^Fmf, Gll^Fmf, Rp^Vhcr, Gll^Edb, Gll, Chr, Khr, Chr, Gll, Hh^Fmf, Hh^Fmf, Hh^Fmf, Gll^Fmf, Gll^Fmf, Gll, Gll^Fmf, Wwf, Wwf, Wwf, Wwf, Wwf, Wwf, Wwf, Wwf, Wwf, Wwf, Ds, Gll^Fmf, Hh^Fmf, Hh^Fmf, Gll^Fmf, Ds, Ww, Ww, Ww, Ds, Ds, Gll^Fmf, Ds, Ds, Ds, Ds, Ww, Ww, Ww^Vm, Wo, Wo, Wo, Wo, Wo, Wo, Wo, Wo
Wo, Wo, Wo, Wo, Wo, Wo, Wo, Ww, Ds, Ds, Ds, Gll^Fmf, Gll^Fmf, Hh^Fmf, Hh^Fmf, Hh^Fmf, Gll^Edb, Gll^Edb, Gll^Edb, Gll^Edb, Gll^Edb, Chr, Gll^Edb, Gll^Fmf, Gll^Fmf, Gll^Fmf, Hh^Fmf, Gll^Fmf, Gll^Fmf, Gll^Fmf, Gll^Fmf, Gll^Fmf, Ds, Wwf, Wwf, Wwf, Wwf, Wwf, Wwf, Wwf, Wwf, Ds, Wwf, Gll^Fmf, Gll^Fmf, Gll^Fmf, Ds, Ww, Ds, Ds, Gll^Fmf, Gll^Fmf, Gll^Fmf, Gll^Fmf, Gll^Fmf, Ds, Ds, Ww, Ww, Ww, Ww, Wo, Wo, Wo, Wo, Wo, Wo, Wo
Wo, Wo, Wo, Wo, Wo, Wo, Wo, Wo, Ww, Ww, Ww, Ds, Ds, Gll^Fmf, Ds, Gll^Fmf, Ds, Gll^Edb, Ds^Edb, Gll^Edb, Ds^Edb, Gll^Edb, Gll^Edb, Gll^Fmf, Gll^Fmf, Gll^Fmf, Gll^Fmf, Gll^Fmf, Ds, Gll^Fmf, Ds, Ds, Ww, Ww, Ww, Wwf, Wwf, Wwf, Wwf, Wwf, Wwf, Wwf, Wwf, Wwf, Ss, Gll^Fmf, Gll^Fmf, Ds, Gll^Fmf, Gll^Fmf, Hh^Fmf, Gll^Fmf, Hh^Fmf, Gll^Fmf, Gll^Fmf, Gll^Fmf, Ds, Ds, Ww, Ww, Ww, Wo, Wo, Wo, Wo, Wo, Wo, Wo
Wo, Wo, Wo, Wo, Wo, Wo, Wo, Wo, Wo, Ww, Ww, Ww, Ww, Ds, Ds, Ds, Ds^Edb, Ds^Edb, Ds^Edb, Ds^Edb, Ww, Ds^Edb, Ds^Edb, Gll^Edb, Ds^Edb, Ds, Ds, Ds, Ww, Ds, Ww, Ww, Ww, Ww, Ww, Ww, Ww, Wwf, Wwf, Wwf, Wwf, Wwf, Wwf, Wwf, Ss, Gll^Fmf, Gll^Fmf, Gll^Efm, Gll^Fmf, Hh^Fmf, Hh^Fmf, Hh^Fmf, Hh^Fmf, Hh^Fmf, Gll^Fmf, Gll^Fmf, Gll^Fmf, Ds, Ww, Ww, Ww, Ww, Wo, Wo, Wo, Wo, Wo, Wo
Wo, Wo, Wo, Wo, Wo, Wo, Wo, Wo, Wo, Wo, Wo, Ww, Wo, Ww, Wo, Ww, Wo, Ww, Ww, Ww, Ww, Ww, Ww, Ds^Edb, Ww, Ww, Ww, Ww, Ww, Ww, Wo, Ww, Wo, Ww, Ww, Ww, Ww, Ww, Ww, Ds, Gll^Fmf, Wwf, Ss^Vhs, Ss, Ss, Ss, Gll^Efm, Gll^Efm, Gll^Efm, Hh^Vhhr, Hh^Fmf, Hh^Fmf, Hh^Fmf, Gll^Fmf, Gll^Fmf, Gll^Fmf, Gll^Fmf, Ds, Ds, Ww, Ww, Ww, Ww, Wo, Wo, Wo, Wo, Wo
Wo, Wo, Wo, Wo, Wo, Wo, Wo, Wo, Wo, Wo, Wo, Wo, Wo, Wo, Wo, Wo, Wo, Wo, Wwr, Wwr, 1 Wwr, Ww, Ww, Ww, Ww, Ww, Wo, Ww, Wo, Wo, Wo, Wo, Wo, Ww, Ww, Ww, Ww, Ww, Ds, Ds, Gll^Fmf, Gll^Fmf, Hh^Fmf, Ss, Hh^Fmf, Gll^Fmf, Gll^Efm, Gll^Efm, Gll^Efm, Gll^Efm, Gll^Fmf, Gll^Fmf, Gll^Fmf, Gll^Fmf, Gll^Fmf, Gll^Fmf, Gll^Fmf, Gll^Fmf, Ds, Ds, Ww, Ww, Ww, Wo, Wo, Wo, Wo, Wo
Wo, Wo, Wo, Wo, Wo, Wo, Wo, Wo, Wo, Wo, Wo, Wo, Wo, Wo, Wo, Wo, Wo, Wo, Wwr, Wwr, Wwr, Ww, Wwr, Ww, Wo, Wo, Wo, Wo, Wo, Wo, Wo, Wo, Wo, Ww, Ww, Ww, Ww, Ds, Ds, Gll^Fmf, Hh^Fmf, Hh^Fmf, Hh^Fmf, Hh^Fmf, Hh^Fmf, Hh^Fmf, Gll^Efm, Gll^Efm, Ds, Gll^Fmf, Ds, Gll^Fmf, Ds, Gll^Fmf, Gll^Fmf, Gll^Fmf, Gll^Fmf, Gll^Fmf, Ds, Ww, Ww, Ww, Ww, Wo, Wo, Wo, Wo, Wo
Wo, Wo, Wo, Wo, Wo, Wo, Wo, Wo, Wo, Wo, Wo, Wo, Wo, Wo, Wo, Wo, Wo, Wo, Wo, Wwr, Wwr, Wwr, Wo, Wo, Wo, Wo, Wo, Wo, Wo, Wo, Wo, Wo, Wo, Ww, Ww, Ww, Ww, Ds, Gll^Fmf, Gll^Fmf, Gll^Fmf, Hh^Fmf, Hh^Fmf, Hh^Fmf, Gll^Fmf, Gll^Efm, Gll^Efm, Ds, Ww, Ds, Ww, Ds, Ww, Ds, Ds, Gll^Fmf, Ds, Ds, Ww, Ww, Ww, Ww, Ww, Wo, Wo, Wo, Wo, Wo
Wo, Wo, Wo, Wo, Wo, Wo, Wo, Wo, Wo, Wo, Wo, Wo, Wo, Wo, Wo, Wo, Wo, Wo, Wo, Wo, Wo, Wo, Wo, Wo, Wo, Wo, Wo, Wo, Wo, Wo, Wo, Wo, Wo, Ww, Ww, Ww, Ww, Ds, Ds, Gll^Fmf, Gll^Fmf, Hh^Fmf, Gll^Fmf, Hh^Fmf, Gll^Fmf, Gll^Fmf, Ds, Ds, Ww, Ww, Ww, Ww, Ww, Ww, Ww, Ds, Ww, Ds, Ww, Ww, Ww, Ww, Wo, Wo, Wo, Wo, Wo, Wo
Wo, Wo, Wo, Wo, Wo, Wo, Wo, Wo, Wo, Wo, Wo, Wo, Wo, Wo, Wo, Wo, Wo, Wo, Wo, Wo, Wo, Wo, Wo, Wo, Wo, Wo, Wo, Wo, Wo, Wo, Wo, Wo, Wo, Wo, Ww, Ww, Ww, Ww, Ww, Ds, Ds, Ds, Ds, Ds, Ds, Ds, Ww, Ww, Ww, Ww, Ww, Ww, Ww, Ww, Ww, Ww, Ww, Ww, Ww, Ww, Ww, Ww, Wo, Wo, Wo, Wo, Wo, Wo
Wo, Wo, Wo, Wo, Wo, Wo, Wo, Wo, Wo, Wo, Wo, Wo, Wo, Wo, Wo, Wo, Wo, Wo, Wo, Wo, Wo, Wo, Wo, Wo, Wo, Wo, Wo, Wo, Wo, Wo, Wo, Wo, Wo, Wo, Ww, Ww, Ww, Ww, Ww, Ww, Ww, Ds, Ww, Ds, Ww, Ww, Ww, Ww, Ww, Ww, Ww, Ww, Ww, Ww, Ww, Ww, Ww, Ww, Ww, Ww, Wo, Wo, Wo, Wo, Wo, Wo, Wo, Wo
Wo, Wo, Wo, Wo, Wo, Wo, Wo, Wo, Wo, Wo, Wo, Wo, Wo, Wo, Wo, Wo, Wo, Wo, Wo, Wo, Wo, Wo, Wo, Wo, Wo, Wo, Wo, Wo, Wo, Wo, Wo, Wo, Wo, Wo, Wo, Ww, Ww, Ww, Ww, Ww, Ww, Ww, Ww, Ww, Ww, Ww, Ww, Ww, Wo, Wo, Wo, Wo, Wo, Ww, Wo, Ww, Wo, Ww, Wo, Wo, Wo, Wo, Wo, Wo, Wo, Wo, Wo, Wo
Wo, Wo, Wo, Wo, Wo, Wo, Wo, Wo, Wo, Wo, Wo, Wo, Wo, Wo, Wo, Wo, Wo, Wo, Wo, Wo, Wo, Wo, Wo, Wo, Wo, Wo, Wo, Wo, Wo, Wo, Wo, Wo, Wo, Wo, Wo, Wo, Wo, Wo, Wo, Ww, Ww, Ww, Ww, Ww, Ww, Ww, Ww, Wo, Wo, Wo, Wo, Wo, Wo, Wo, Wo, Wo, Wo, Wo, Wo, Wo, Wo, Wo, Wo, Wo, Wo, Wo, Wo, Wo
Wo, Wo, Wo, Wo, Wo, Wo, Wo, Wo, Wo, Wo, Wo, Wo, Wo, Wo, Wo, Wo, Wo, Wo, Wo, Wo, Wo, Wo, Wo, Wo, Wo, Wo, Wo, Wo, Wo, Wo, Wo, Wo, Wo, Wo, Wo, Wo, Wo, Wo, Wo, Wo, Wo, Wo, Wo, Ww, Wo, Ww, Wo, Wo, Wo, Wo, Wo, Wo, Wo, Wo, Wo, Wo, Wo, Wo, Wo, Wo, Wo, Wo, Wo, Wo, Wo, Wo, Wo, Wo
Wo, Wo, Wo, Wo, Wo, Wo, Wo, Wo, Wo, Wo, Wo, Wo, Wo, Wo, Wo, Wo, Wo, Wo, Wo, Wo, Wo, Wo, Wo, Wo, Wo, Wo, Wo, Wo, Wo, Wo, Wo, Wo, Wo, Wo, Wo, Wo, Wo, Wo, Wo, Wo, Wo, Wo, Wo, Wo, Wo, Wo, Wo, Wo, Wo, Wo, Wo, Wo, Wo, Wo, Wo, Wo, Wo, Wo, Wo, Wo, Wo, Wo, Wo, Wo, Wo, Wo, Wo, Wo
